{
  "name": "Abandoned_Settlement",
  "width": 30,
  "height": 30,
  "layers": [
    [
      [1379, 1380, 733, 733, 733, 733, 733, 733, 733, 733, 732, 732, 732, 733, 732, 732, 732, 732, 732, 732, 732, 732, 732, 732, 732, 732, 732, 732, 732, 732],
      [1380, 733, 733, 733, 733, 733, 733, 733, 732, 733, 733, 733, 732, 733, 732, 732, 732, 732, 732, 732, 732, 732, 732, 732, 732, 732, 732, 732, 732, 732],
      [733, 1380, 733, 733, 733, 733, 733, 733, 732, 732, 733, 732, 733, 733, 732, 732, 732, 732, 732, 732, 732, 732, 732, 732, 732, 732, 732, 732, 732, 732],
      [733, 733, 233, 228, 228, 228, 228, 234, 733, 733, 732, 732, 733, 732, 733, 732, 732, 732, 732, 732, 732, 732, 732, 732, 732, 732, 732, 732, 732, 732],
      [733, 1380, 231, 221, 221, 222, 221, 231, 732, 732, 732, 732, 732, 733, 733, 732, 732, 732, 732, 732, 732, 732, 732, 732, 732, 732, 732, 732, 732, 732],
      [733, 733, 219, 221, 222, 221, 221, 218, 732, 732, 732, 732, 733, 732, 733, 732, 732, 732, 732, 732, 732, 732, 732, 732, 732, 732, 732, 732, 732, 732],
      [1379, 733, 733, 222, 221, 221, 222, 733, 732, 733, 732, 733, 732, 732, 732, 732, 732, 732, 732, 732, 732, 732, 732, 732, 732, 732, 732, 732, 732, 732],
      [733, 733, 733, 221, 221, 222, 221, 733, 732, 733, 732, 732, 1400, 1400, 1400, 1400, 1400, 1400, 1400, 1400, 1400, 1400, 1400, 1400, 1400, 1400, 1400, 1400, 1400, 1400],
      [733, 733, 235, 733, 733, 733, 733, 236, 733, 732, 732, 1442, 1379, 1380, 1379, 1380, 1379, 1380, 1379, 1380, 1379, 1380, 1379, 1380, 1379, 1380, 1379, 1380, 1379, 1380],
      [1380, 1379, 733, 1379, 733, 733, 733, 733, 733, 733, 1399, 1380, 1401, 1398, 1398, 1398, 1398, 1398, 1398, 1398, 1398, 1398, 1398, 1398, 1398, 1398, 1398, 1398, 1398, 1398],
      [1379, 733, 1379, 733, 733, 733, 733, 733, 732, 732, 1399, 1379, 1401, 221, 222, 221, 221, 221, 231, 732, 732, 732, 732, 732, 732, 732, 732, 732, 732, 732],
      [733, 733, 733, 1379, 733, 733, 733, 733, 732, 733, 1399, 1380, 1401, 222, 221, 221, 221, 222, 231, 732, 732, 732, 732, 732, 732, 732, 732, 732, 732, 732],
      [733, 733, 1379, 1380, 733, 733, 733, 733, 733, 733, 1399, 1379, 1401, 221, 221, 221, 222, 221, 231, 732, 732, 732, 732, 732, 732, 732, 732, 732, 732, 732],
      [733, 733, 1380, 1379, 733, 733, 733, 733, 732, 732, 1399, 1380, 1401, 221, 221, 222, 221, 221, 231, 732, 732, 732, 732, 732, 732, 732, 732, 732, 732, 732],
      [1379, 1380, 1400, 1380, 1400, 1400, 1400, 1400, 1400, 1400, 1400, 1379, 1401, 228, 228, 732, 732, 228, 236, 732, 732, 732, 732, 732, 732, 732, 732, 732, 732, 732],
      [1379, 1380, 1379, 1380, 1379, 1380, 1379, 1380, 1379, 1380, 1379, 1442, 732, 732, 732, 732, 732, 732, 732, 732, 732, 732, 732, 732, 732, 732, 732, 732, 732, 732],
      [1398, 1398, 1398, 1398, 1398, 1398, 1398, 1398, 1398, 1398, 1398, 732, 733, 733, 732, 732, 732, 732, 732, 732, 732, 732, 732, 732, 732, 732, 732, 732, 732, 732],
      [733, 733, 733, 733, 733, 733, 733, 733, 732, 732, 732, 733, 732, 732, 732, 732, 732, 732, 732, 732, 732, 732, 732, 732, 732, 732, 732, 732, 732, 732],
      [1379, 733, 733, 733, 1379, 733, 733, 733, 732, 732, 733, 732, 733, 733, 732, 732, 732, 732, 732, 732, 233, 228, 228, 228, 228, 228, 234, 732, 732, 732],
      [1380, 1379, 733, 733, 733, 733, 733, 733, 733, 733, 733, 732, 733, 733, 732, 732, 732, 732, 732, 732, 231, 223, 221, 221, 221, 221, 231, 732, 732, 732],
      [1379, 733, 1379, 1380, 733, 733, 733, 733, 733, 733, 732, 733, 732, 733, 732, 732, 732, 732, 732, 732, 231, 221, 221, 221, 221, 223, 231, 732, 732, 732],
      [733, 1379, 733, 1379, 733, 733, 733, 733, 733, 732, 732, 732, 732, 732, 732, 732, 732, 732, 732, 732, 231, 221, 221, 221, 223, 221, 231, 732, 732, 732],
      [733, 733, 733, 733, 733, 733, 733, 733, 733, 732, 733, 732, 732, 733, 732, 732, 732, 732, 732, 732, 231, 221, 221, 223, 221, 221, 231, 732, 732, 732],
      [733, 1379, 733, 1379, 733, 733, 733, 733, 732, 732, 732, 732, 732, 732, 733, 732, 732, 732, 732, 732, 231, 221, 223, 221, 221, 221, 231, 732, 732, 732],
      [1379, 733, 1379, 733, 733, 733, 733, 733, 732, 732, 732, 732, 732, 732, 732, 732, 732, 732, 732, 732, 235, 228, 228, 228, 228, 228, 236, 732, 732, 732],
      [1380, 1379, 733, 733, 1380, 733, 733, 733, 732, 732, 732, 732, 732, 732, 733, 732, 732, 732, 732, 732, 732, 732, 732, 732, 732, 732, 732, 732, 732, 732],
      [733, 733, 733, 733, 1379, 733, 733, 733, 732, 732, 733, 732, 732, 732, 732, 732, 732, 732, 732, 732, 732, 732, 732, 732, 732, 732, 732, 732, 732, 732],
      [733, 1379, 733, 1379, 733, 733, 733, 733, 733, 733, 733, 733, 732, 733, 732, 732, 732, 732, 732, 732, 732, 732, 732, 732, 732, 732, 732, 732, 732, 732],
      [733, 1380, 1379, 1380, 733, 733, 733, 733, 733, 733, 733, 732, 733, 733, 732, 732, 732, 732, 732, 732, 732, 732, 732, 732, 732, 732, 732, 732, 732, 732],
      [733, 733, 1380, 733, 1380, 733, 733, 733, 732, 732, 732, 733, 732, 732, 732, 732, 732, 732, 732, 732, 732, 732, 732, 732, 732, 732, 732, 732, 732, 732]
    ],
    [
      [0, 0, 0, 0, 0, 0, 0, 0, 0, 0, 0, 0, 0, 0, 0, 0, 0, 0, 0, 0, 0, 0, 0, 0, 0, 0, 0, 0, 0, 0],
      [0, 0, 0, 0, 0, 0, 0, 0, 0, 0, 0, 0, 0, 0, 0, 0, 0, 0, 0, 0, 0, 0, 0, 0, 0, 0, 0, 0, 0, 0],
      [0, 0, 0, 0, 0, 0, 0, 0, 0, 0, 0, 0, 0, 0, 0, 0, 0, 0, 0, 0, 0, 0, 0, 0, 0, 0, 0, 0, 0, 0],
      [0, 0, 0, 0, 0, 0, 0, 0, 0, 0, 0, 0, 0, 0, 0, 0, 0, 154, 0, 0, 0, 0, 0, 0, 0, 0, 0, 0, 0, 0],
      [0, 0, 0, 0, 0, 0, 0, 0, 0, 208, 0, 0, 0, 0, 0, 0, 0, 0, 0, 0, 0, 0, 0, 0, 0, 0, 0, 0, 0, 0],
      [0, 0, 0, 0, 0, 0, 0, 0, 0, 0, 0, 0, 0, 0, 0, 0, 0, 0, 0, 0, 0, 0, 0, 0, 0, 0, 0, 0, 0, 0],
      [0, 0, 0, 0, 201, 203, 0, 0, 0, 0, 0, 0, 0, 0, 0, 0, 0, 0, 0, 0, 0, 0, 0, 0, 0, 0, 0, 0, 0, 0],
      [0, 0, 0, 0, 0, 0, 0, 0, 0, 0, 0, 0, 0, 0, 0, 0, 0, 0, 0, 0, 0, 0, 0, 0, 0, 0, 0, 0, 0, 0],
      [0, 0, 0, 38, 0, 38, 0, 0, 0, 0, 0, 0, 0, 0, 0, 0, 0, 0, 0, 0, 0, 0, 0, 0, 0, 0, 0, 0, 0, 0],
      [0, 0, 0, 0, 0, 0, 0, 0, 0, 0, 0, 0, 0, 0, 0, 0, 0, 0, 0, 0, 0, 0, 0, 0, 0, 0, 0, 0, 0, 0],
      [0, 209, 0, 0, 0, 0, 0, 0, 98, 99, 0, 0, 0, 0, 470, 0, 0, 255, 0, 0, 0, 0, 0, 0, 0, 0, 0, 0, 0, 0],
      [0, 0, 0, 0, 0, 0, 0, 0, 0, 0, 0, 0, 0, 0, 0, 249, 251, 0, 0, 0, 0, 0, 0, 0, 0, 0, 0, 0, 0, 0],
      [0, 0, 0, 0, 0, 0, 0, 0, 100, 98, 0, 0, 0, 0, 0, 0, 0, 0, 0, 0, 0, 0, 0, 0, 0, 0, 0, 0, 0, 0],
      [0, 0, 0, 0, 0, 0, 0, 0, 0, 0, 0, 0, 0, 209, 0, 0, 0, 0, 0, 0, 0, 0, 0, 0, 0, 0, 0, 0, 0, 0],
      [0, 0, 0, 0, 0, 0, 0, 0, 0, 0, 0, 0, 0, 0, 0, 0, 0, 0, 0, 0, 0, 0, 0, 0, 0, 0, 0, 0, 0, 0],
      [0, 0, 0, 0, 0, 0, 0, 0, 0, 0, 0, 0, 0, 0, 0, 0, 0, 0, 0, 0, 0, 0, 0, 0, 0, 0, 0, 0, 0, 0],
      [0, 0, 0, 0, 0, 0, 0, 0, 0, 0, 0, 98, 0, 0, 0, 0, 0, 0, 0, 0, 0, 0, 0, 0, 0, 0, 0, 0, 0, 0],
      [0, 0, 0, 0, 0, 0, 0, 0, 99, 100, 98, 0, 0, 0, 0, 0, 0, 0, 0, 0, 0, 0, 0, 0, 0, 0, 0, 0, 0, 0],
      [0, 209, 0, 0, 0, 0, 0, 0, 0, 0, 0, 0, 0, 0, 0, 0, 0, 0, 0, 0, 0, 0, 0, 0, 0, 0, 0, 0, 0, 0],
      [0, 0, 0, 0, 0, 0, 0, 0, 0, 0, 0, 0, 0, 0, 0, 0, 0, 0, 0, 0, 0, 0, 0, 0, 0, 0, 0, 0, 0, 0],
      [0, 0, 0, 0, 0, 0, 0, 0, 0, 208, 0, 0, 0, 0, 0, 0, 0, 0, 0, 0, 0, 0, 0, 0, 0, 0, 0, 0, 0, 0],
      [0, 0, 0, 0, 0, 0, 0, 0, 0, 0, 0, 0, 0, 0, 0, 0, 0, 0, 0, 0, 0, 0, 0, 252, 0, 0, 0, 0, 0, 0],
      [0, 0, 0, 209, 0, 0, 0, 0, 0, 0, 0, 0, 0, 0, 0, 0, 0, 0, 0, 0, 0, 0, 473, 0, 0, 0, 0, 0, 0, 0],
      [0, 0, 0, 0, 0, 0, 0, 0, 0, 0, 0, 0, 0, 0, 0, 0, 0, 0, 0, 0, 0, 0, 0, 0, 0, 0, 0, 0, 0, 0],
      [0, 0, 0, 0, 0, 0, 0, 0, 0, 0, 0, 0, 0, 0, 0, 0, 0, 0, 0, 0, 0, 0, 0, 0, 0, 0, 0, 0, 0, 0],
      [0, 0, 0, 0, 0, 0, 0, 0, 0, 0, 0, 0, 0, 0, 154, 0, 0, 0, 0, 0, 0, 0, 0, 0, 0, 0, 0, 0, 0, 0],
      [0, 0, 209, 0, 0, 0, 0, 0, 0, 0, 208, 0, 0, 0, 0, 0, 0, 0, 0, 0, 0, 0, 0, 0, 0, 0, 0, 0, 0, 0],
      [0, 0, 0, 0, 0, 0, 0, 0, 0, 0, 0, 0, 0, 0, 0, 0, 0, 0, 0, 0, 0, 0, 0, 0, 0, 0, 0, 0, 0, 0],
      [0, 0, 0, 0, 0, 0, 0, 0, 0, 0, 0, 0, 0, 0, 0, 0, 0, 0, 0, 0, 0, 0, 154, 0, 0, 0, 0, 0, 0, 0],
      [0, 0, 0, 0, 0, 0, 0, 0, 0, 0, 0, 0, 0, 0, 0, 0, 0, 0, 0, 0, 0, 0, 0, 0, 0, 0, 0, 0, 0, 0]
    ]
  ],
  "legend": {"732": "grass", "733": "bog", "221": "floor", "228": "wall", "0": "empty overlay"},
  "spawns": {"player": {"x": 28, "y": 8}},
  "exits": {"east": {"tiles": [[29, 7], [29, 8], [29, 9]], "destination": "Great_Open_Bog", "entryPoint": "west"}, "west": {"tiles": [[0, 14], [0, 15], [0, 16]], "destination": "Fortress_Of_Blood", "entryPoint": "east"}, "south": {"tiles": [[15, 29], [16, 29], [17, 29]], "destination": "Cursed_Wood", "entryPoint": "north"}},
 "entries": {"west": {"x": 1, "yFromSource": true, "y": 15}, "east": {"x": 28, "yFromSource": true, "y": 8}, "south": {"x": 15, "yFromSource": false, "y": 27}, "north": {"x": 15, "yFromSource": false, "y": 2}}
}
