{
  "name": "Bog_Threshold",
  "width": 36,
  "height": 36,
  "layers": [
    [
      [1380,1379,1380,1379,1380,1379,1380,1379,1380,1379,1380,1379,1380,1379,1380,1379,1380,1379,1380,1379,1380,1379,1380,1379,1380,1379,1380,1379,1380,1379,1380,1379,1380,1379,1380,1379],
      [1379,1380,1379,1380,1379,1380,1379,1380,1379,1380,1379,1380,1379,1380,1379,1380,1379,1380,1379,1380,1379,1380,1379,1380,1379,1380,1379,1380,1379,1380,1379,1380,1379,1380,1379,1380],
      [1380,1379,1380,1379,1380,1379,1380,1379,1380,1179,1380,1179,1380,1179,1380,1179,1380,1179,1380,1179,1380,1179,1380,1179,1380,1179,1380,1179,1380,1179,1380,1379,1380,1379,1380,1379],
      [1379,1380,1379,1380,1379,1380,1379,1380,1472,1634,1474,1634,1474,1634,1474,1634,1474,1634,1474,1634,1474,1634,1474,1634,1474,1634,1474,1634,1474,1634,1473,1380,1379,1380,1379,1380],
      [1380,1179,1380,1179,1380,1179,1380,1526,1634,1634,1634,1634,1634,1634,1634,1634,1634,1634,1634,1634,1634,1634,1634,1634,1634,1634,1634,1634,1634,1634,1634,1528,1380,1179,1380,1179],
      [1179,1634,1179,1634,1179,1634,1580,1634,1634,1634,1634,1634,1634,1634,1634,1634,1634,1634,1634,1634,1634,1634,1634,1634,1634,1634,1634,1634,1634,1634,1634,1634,1582,1634,1179,1634],
      [1634,1634,1634,1634,1634,1634,1634,1634,1634,1634,1634,1634,1634,1634,1634,1634,1634,1634,1634,1634,1634,1634,1634,1634,1634,1634,1634,1634,1634,1634,1634,1634,1634,1634,1634,1634],
      [1179,1634,1179,1634,1179,1634,1580,1634,1634,1634,1634,1634,1634,1634,1634,1634,1634,1634,1634,1634,1634,1634,1634,1634,1634,1634,1634,1634,1634,1634,1634,1634,1582,1634,1179,1634],
      [1380,1179,1380,1179,1380,1179,1380,1526,1634,1634,1634,1634,1634,1634,1634,1634,1634,1634,1634,1634,1634,1634,1634,1634,1634,1634,1634,1634,1634,1634,1634,1528,1380,1179,1380,1179],
      [1379,1380,1379,1380,1379,1380,1379,1380,1472,1634,1474,1634,1474,1634,1474,1634,1474,1634,1474,1634,1474,1634,1474,1634,1474,1634,1474,1634,1474,1634,1473,1380,1379,1380,1379,1380],
      [1380,1379,1380,1379,1380,1379,1380,1379,1380,1179,1380,1179,1380,1179,1380,1179,1380,1179,1380,1179,1380,1179,1380,1179,1380,1179,1380,1179,1380,1179,1380,1379,1380,1379,1380,1379],
      [1379,1380,1379,1380,1379,1380,1379,1380,1379,1380,1379,1380,1379,1380,1379,1380,1379,1380,1379,1380,1379,1380,1379,1380,1379,1380,1379,1380,1379,1380,1379,1380,1379,1380,1379,1380],
      [1380,1379,1380,1379,1380,1379,1380,1379,1380,1379,1380,1379,1380,1379,1380,1379,1380,1379,1380,1379,1380,1379,1380,1379,1380,1379,1380,1379,1380,1379,1380,1379,1380,1379,1380,1379],
      [1379,1380,1379,1380,1379,1380,1379,1380,1379,1380,1379,1380,1379,1380,1379,1380,1379,1380,1379,1380,1379,1380,1379,1380,1379,1380,1379,1380,1379,1380,1379,1380,1379,1380,1379,1380],
      [1380,1379,1380,1379,1380,1379,1380,1379,1380,1379,1380,1379,1380,1379,1380,1379,1380,1379,1380,1379,1380,1379,1380,1379,1380,1379,1380,1379,1380,1379,1380,1379,1380,1379,1380,1379],
      [1379,1380,1379,1380,1379,1380,1379,1380,1379,1380,1379,1380,1379,1380,1379,1445,1444,1444,1444,1444,1444,1444,1444,1444,1444,1444,1444,1444,1444,1444,1444,1380,1379,1380,1379,1380],
      [1380,1379,1380,1379,1380,1379,1380,1379,1380,1379,1380,1379,1380,1379,1380,1447,1379,1380,1379,1380,1379,1380,1379,1380,1379,1380,1379,1380,1379,1380,1446,1379,1380,1379,1380,1379],
      [1379,1380,1379,1380,1379,1380,1379,1380,1379,1380,1379,1380,1379,1380,1379,1447,1380,1379,1380,1379,1380,1379,1380,1379,1380,1379,1380,1379,1380,1379,1446,1380,1379,1380,1379,1380],
      [1380,1379,1380,1379,1380,1379,1380,1379,1380,1379,1380,1379,1380,1379,1380,1448,1444,1444,1444,1444,1444,1444,1444,1444,1444,1444,1444,1444,1444,1444,1444,1379,1380,1379,1380,1379],
      [1379,1380,1379,1380,1379,1380,1379,1380,1379,1380,1379,1380,1379,1380,1379,1380,1379,1380,1379,1380,1379,1380,1379,1380,1379,1380,1379,1380,1379,1380,1379,1380,1379,1380,1379,1380],
      [1380,1379,1380,1379,1380,1379,1380,1379,1380,1379,1380,1379,1380,1379,1380,1379,1380,1379,1380,1379,1380,1379,1380,1379,1380,1379,1380,1379,1380,1379,1380,1379,1380,1379,1380,1379],
      [1379,1380,1179,1380,1179,1380,1179,1380,1379,1380,1379,1380,1379,1380,1379,1380,1379,1380,1379,1380,1379,1380,1379,1380,1379,1380,1379,1380,1379,1380,1179,1380,1179,1380,1179,1380],
      [1380,1472,1634,1474,1634,1474,1634,1473,1380,1379,1380,1379,1380,1379,1380,1379,1380,1379,1380,1379,1380,1379,1380,1379,1380,1379,1380,1379,1380,1472,1634,1474,1634,1474,1634,1473],
      [1526,1634,1634,1634,1634,1634,1634,1528,1379,1380,1379,1380,1379,1380,1379,1380,1379,1380,1379,1380,1379,1380,1379,1380,1379,1380,1379,1380,1526,1634,1634,1634,1634,1634,1634,1528],
      [1580,1634,1634,1634,1634,1634,1634,1582,1380,1379,1380,1379,1380,1379,1380,1379,1380,1179,1380,1379,1380,1379,1380,1179,1380,1379,1380,1379,1580,1634,1634,1634,1634,1634,1634,1582],
      [1526,1634,1634,1634,1634,1634,1634,1528,1379,1380,1379,1380,1379,1380,1379,1380,1379,1380,1379,1380,1379,1380,1379,1380,1379,1380,1379,1380,1526,1634,1634,1634,1634,1634,1634,1528],
      [1380,1472,1634,1474,1634,1474,1634,1473,1380,1379,1380,1379,1380,1379,1380,1379,1380,1379,1380,1379,1380,1379,1380,1379,1380,1379,1380,1379,1380,1472,1634,1474,1634,1474,1634,1473],
      [1379,1380,1179,1380,1179,1380,1179,1380,1379,1380,1379,1380,1379,1380,1379,1380,1379,1380,1379,1380,1379,1380,1379,1380,1379,1380,1379,1380,1379,1380,1179,1380,1179,1380,1179,1380],
      [1380,1379,1380,1379,1380,1379,1380,1379,1380,1379,1380,1379,1380,1379,1380,1379,1380,1379,1380,1379,1380,1379,1380,1379,1380,1379,1380,1379,1380,1379,1380,1379,1380,1379,1380,1379],
      [1379,1380,1379,1380,1379,1380,1379,1380,1379,1380,1379,1380,1379,1380,1379,1380,1379,1380,1379,1380,1379,1380,1379,1380,1379,1380,1379,1380,1379,1380,1379,1380,1379,1380,1379,1380],
      [1380,1379,1380,1379,1380,1379,1380,1379,1380,1379,1380,1379,1380,1379,1380,1379,1380,1379,1380,1379,1380,1379,1380,1379,1380,1379,1380,1379,1380,1379,1380,1379,1380,1379,1380,1379],
      [1379,1380,1379,1380,1379,1380,1379,1380,1379,1380,1379,1380,1379,1380,1379,1380,1379,1380,1379,1380,1379,1380,1379,1380,1379,1380,1379,1380,1379,1380,1379,1380,1379,1380,1379,1380],
      [1380,1379,1380,1379,1380,1379,1380,1379,1380,1379,1380,1379,1380,1379,1380,1179,1380,1179,1380,1179,1380,1179,1380,1179,1380,1179,1380,1179,1380,1179,1380,1379,1380,1379,1380,1379],
      [1379,1380,1379,1380,1379,1380,1379,1380,1379,1380,1379,1380,1379,1380,1472,1634,1474,1634,1474,1634,1474,1634,1474,1634,1474,1634,1474,1634,1474,1634,1473,1380,1379,1380,1379,1380],
      [1380,1179,1380,1179,1380,1179,1380,1526,1634,1634,1634,1634,1634,1634,1634,1634,1634,1634,1634,1634,1634,1634,1634,1634,1634,1634,1634,1634,1634,1634,1634,1528,1380,1179,1380,1179],
      [1379,1380,1379,1380,1379,1380,1379,1380,1379,1380,1379,1380,1379,1380,1379,1380,1379,1380,1379,1380,1379,1380,1379,1380,1379,1380,1379,1380,1379,1380,1379,1380,1379,1380,1379,1380]
    ],
    [
      [0,0,0,0,0,0,0,0,0,0,0,0,0,0,0,0,0,0,0,0,0,0,0,0,0,0,0,0,0,0,0,0,0,0,0,0],
      [0,50,0,0,50,0,0,0,50,0,0,50,0,0,0,50,0,0,50,0,0,0,50,0,0,50,0,0,0,50,0,0,50,0,0,0],
      [0,0,0,50,0,0,50,0,0,0,0,0,50,0,0,0,50,0,0,0,50,0,0,0,0,0,50,0,0,0,50,0,0,0,50,0],
      [0,0,50,0,0,0,0,50,0,0,0,50,0,0,50,0,0,0,0,50,0,0,0,50,0,0,0,0,50,0,0,0,0,50,0,0],
      [0,0,0,0,0,50,0,0,0,0,0,0,0,0,0,0,0,0,0,0,0,0,0,0,0,0,0,0,0,0,0,0,0,0,0,0],
      [0,0,0,0,0,0,0,0,0,0,0,0,0,0,0,0,0,0,0,0,0,0,0,0,0,0,0,0,0,0,0,0,0,0,0,0],
      [0,0,0,0,0,0,0,0,0,0,0,0,0,0,0,0,0,0,0,0,0,0,0,0,0,0,0,0,0,0,0,0,0,0,0,0],
      [0,0,0,0,0,0,0,0,0,0,0,0,0,0,0,0,0,0,0,0,0,0,0,0,0,0,0,0,0,0,0,0,0,0,0,0],
      [0,0,0,0,0,50,0,0,0,0,0,0,0,0,0,0,0,0,0,0,0,0,0,0,0,0,0,0,0,0,0,0,0,0,0,0],
      [0,50,0,0,0,50,0,0,50,0,0,0,0,50,0,50,0,0,0,50,0,0,0,0,0,50,0,0,0,0,50,0,0,0,50,0],
      [0,0,0,50,0,0,0,50,0,0,50,0,0,0,50,0,0,0,50,0,0,50,0,0,0,0,50,0,0,50,0,0,0,0,0,0],
      [0,0,217,0,217,0,0,0,50,0,0,0,50,0,0,0,0,50,0,0,0,0,50,0,0,50,0,0,0,50,0,0,50,0,0,0],
      [0,0,219,0,218,0,50,0,0,0,0,50,0,0,0,50,0,0,0,0,50,0,0,0,0,0,0,50,0,0,0,50,0,0,0,0],
      [0,0,217,0,217,0,0,0,50,0,50,0,0,50,0,0,0,50,0,50,0,0,0,0,50,0,0,0,0,0,50,0,0,0,50,0],
      [0,0,0,0,0,0,0,50,0,0,0,0,50,0,0,0,50,0,0,0,0,50,0,0,0,0,50,0,0,50,0,0,0,0,0,0],
      [0,0,0,0,0,50,0,0,0,50,0,50,0,0,0,0,0,0,0,0,0,0,0,0,0,0,0,0,0,0,0,0,0,50,0,0],
      [0,50,0,217,0,0,0,0,50,0,0,0,218,0,0,0,0,0,0,0,0,0,0,0,0,0,0,0,0,0,0,0,0,0,50,0],
      [0,0,0,217,0,0,50,0,0,0,50,0,219,0,0,0,0,0,0,0,0,0,0,0,0,0,0,0,0,0,0,0,50,0,0,0],
      [0,0,0,0,0,50,0,0,0,0,0,50,0,0,0,0,0,0,0,0,0,0,0,0,0,0,0,0,0,0,0,0,0,0,0,50],
      [0,50,0,0,50,0,0,0,50,0,50,0,0,50,0,0,0,50,0,0,0,50,0,0,0,0,50,0,0,0,0,50,0,0,50,0],
      [0,0,0,50,0,0,0,50,0,0,0,0,50,0,0,0,50,0,0,0,0,0,50,0,0,50,0,0,50,0,0,0,0,0,0,0],
      [0,0,50,0,0,50,0,0,0,0,50,0,0,0,50,0,0,0,0,50,0,0,0,0,0,0,0,50,0,0,0,50,0,0,0,50],
      [0,0,0,0,0,0,0,0,0,0,0,0,0,50,0,0,50,0,0,0,50,0,0,0,0,50,0,0,0,0,50,0,0,50,0,0],
      [0,0,0,0,50,0,50,0,0,0,50,0,50,0,0,50,0,0,0,0,0,50,0,0,50,0,0,0,50,0,0,0,0,0,50,0],
      [0,0,50,0,0,0,0,0,0,50,0,0,0,0,50,0,0,0,50,0,0,0,0,0,0,0,50,0,0,0,50,0,50,0,0,0],
      [0,50,0,0,0,50,0,50,0,0,0,50,0,50,0,0,0,50,0,0,50,0,0,50,0,0,0,0,0,50,0,0,0,0,0,50],
      [0,0,0,50,0,0,0,0,0,0,50,0,0,0,0,50,0,0,0,0,0,0,50,0,0,0,50,0,0,0,0,50,0,0,50,0],
      [0,0,50,0,0,0,50,0,50,0,0,0,50,0,50,0,0,0,0,50,0,50,0,0,0,50,0,0,50,0,0,0,0,0,0,0],
      [0,50,0,0,50,0,0,50,0,0,0,0,0,0,0,0,50,0,0,0,0,0,0,50,0,0,0,0,0,0,50,0,0,50,0,50],
      [0,0,0,0,0,0,50,0,0,0,50,0,0,50,0,0,0,50,0,0,50,0,0,0,0,0,50,0,0,0,0,0,50,0,0,0],
      [0,0,50,0,50,0,0,0,0,50,0,0,0,0,0,50,0,0,0,50,0,0,0,0,50,0,0,0,50,0,0,50,0,0,0,0],
      [0,50,0,0,0,0,0,50,0,0,0,50,0,0,50,0,0,50,0,0,0,50,0,0,0,0,50,0,0,0,0,0,0,0,50,0],
      [0,0,0,50,0,50,0,0,0,0,50,0,0,0,0,0,50,0,0,0,50,0,0,0,0,50,0,0,0,50,0,0,50,0,0,0],
      [0,0,50,0,0,0,0,0,0,0,0,0,50,0,0,0,0,0,0,50,0,0,50,0,0,0,0,50,0,0,0,0,0,0,0,50],
      [0,50,0,0,50,0,50,0,0,0,0,50,0,0,0,50,0,50,0,0,0,50,0,0,50,0,0,0,50,0,50,0,0,0,50,0],
      [0,0,0,0,0,0,0,0,0,0,0,0,0,0,0,0,0,0,0,0,0,0,0,0,0,0,0,0,0,0,0,0,0,0,0,0]
    ]
  ],
  "legend": {
    "1379": "plain mud",
    "1380": "mud with twigs",
    "1634": "bog water tile 1",
    "1688": "bog water tile 2",
    "1179": "bog water stepping stone",
    "1472": "west and north shore",
    "1473": "north and east shore",
    "1474": "north shore",
    "1526": "west shore",
    "1528": "east shore",
    "1580": "west and south shore",
    "1581": "south shore",
    "1582": "south and east shore",
    "1444": "mud tiny straight top edge",
    "1445": "mud tiny straight top edge north",
    "1446": "strip transparency east edge mud",
    "1447": "transparent strip west side mud",
    "1448": "transparent strip south side mud",
    "217":  "bog block solid",
    "218":  "bog block cracked",
    "219":  "bog block very cracked",
    "50":   "medium bog bush",
    "0":    "empty overlay"
  },
  "spawns": {
    "player": { "x": 30, "y": 16 }
  },
  "exits": {
    "west": {
      "tiles": [[3,15],[3,16],[3,17]],
      "destination": "Great_Open_Bog",
      "entryPoint": "east"
    },
    "east": {
      "tiles": [[32,15],[32,16],[32,17]],
      "destination": "Oak_Wood",
      "entryPoint": "west"
    }
  },
  "entries": {
    "west":  { "x": 4,  "yFromSource": true,  "y": 16 },
    "east":  { "x": 31, "yFromSource": true,  "y": 16 },
    "north": { "x": 18, "yFromSource": false, "y": 5  },
    "south": { "x": 18, "yFromSource": false, "y": 30 }
  }
}

