{
  "name": "Bog_Threshold",
  "width": 30,
  "height": 30,
  "layers": [
    [
      [1379, 733, 733, 733, 1379, 1380, 733, 733, 733, 733, 733, 733, 733, 733, 733, 733, 733, 733, 733, 733, 839, 840, 839, 840, 839, 840, 839, 840, 839, 840],
      [1380, 1379, 733, 1379, 733, 1379, 733, 733, 733, 733, 733, 733, 733, 733, 733, 733, 733, 733, 733, 733, 840, 839, 840, 839, 840, 839, 840, 839, 840, 839],
      [1379, 733, 733, 733, 1379, 1380, 733, 733, 733, 733, 733, 733, 733, 733, 733, 733, 733, 733, 733, 733, 839, 840, 839, 840, 839, 840, 839, 840, 839, 840],
      [1380, 733, 733, 733, 733, 733, 733, 733, 733, 733, 733, 733, 733, 733, 733, 733, 733, 733, 733, 733, 840, 839, 840, 839, 840, 839, 840, 839, 840, 839],
      [733, 733, 1379, 733, 733, 733, 733, 733, 733, 733, 733, 733, 733, 733, 733, 840, 839, 840, 839, 840, 839, 840, 839, 840, 839, 840, 839, 840, 839, 840],
      [733, 733, 733, 733, 1380, 1379, 733, 733, 733, 733, 840, 839, 840, 839, 840, 839, 840, 839, 840, 839, 840, 839, 840, 839, 840, 839, 840, 839, 840, 839],
      [733, 733, 733, 733, 733, 733, 733, 733, 733, 733, 733, 733, 733, 840, 839, 840, 839, 840, 839, 840, 839, 840, 839, 840, 839, 840, 839, 840, 839, 840],
      [1380, 733, 733, 1379, 1380, 733, 733, 733, 733, 733, 733, 733, 733, 733, 733, 733, 733, 733, 840, 839, 840, 839, 840, 839, 840, 839, 840, 839, 840, 839],
      [1379, 733, 733, 733, 1379, 733, 733, 733, 733, 733, 733, 733, 733, 733, 733, 733, 733, 733, 839, 840, 839, 840, 839, 840, 839, 840, 839, 840, 839, 840],
      [1380, 1379, 1380, 733, 1380, 733, 733, 733, 733, 733, 733, 733, 733, 733, 733, 733, 733, 733, 840, 839, 840, 839, 840, 839, 840, 839, 840, 839, 840, 839],
      [733, 733, 733, 733, 1379, 1380, 733, 733, 733, 733, 839, 840, 839, 840, 839, 840, 839, 840, 839, 840, 839, 840, 839, 840, 839, 840, 839, 840, 839, 840],
      [733, 733, 733, 1379, 733, 733, 733, 733, 733, 733, 733, 733, 840, 732, 732, 732, 840, 839, 840, 839, 840, 839, 840, 839, 840, 839, 840, 839, 840, 839],
      [733, 733, 1379, 733, 733, 733, 733, 733, 733, 733, 733, 733, 733, 732, 732, 732, 733, 840, 839, 840, 839, 840, 839, 840, 839, 840, 839, 840, 839, 840],
      [1380, 733, 733, 733, 1380, 733, 733, 733, 733, 1400, 733, 733, 1400, 1400, 1400, 1400, 1400, 1400, 1400, 1400, 1400, 1400, 1400, 1400, 1400, 1400, 1400, 1400, 1400, 1400],
      [733, 733, 733, 733, 1379, 1380, 733, 1380, 1379, 733, 1379, 1380, 1379, 1380, 1379, 1380, 1379, 1380, 1379, 1380, 1379, 1380, 1379, 1380, 1379, 1380, 1379, 1380, 1379, 1380],
      [1380, 733, 1380, 1379, 1380, 733, 733, 1398, 733, 1398, 840, 1398, 1398, 1398, 1398, 1398, 1398, 1398, 1398, 1398, 1398, 1398, 1398, 1398, 1398, 1398, 1398, 1398, 1398, 1398],
      [733, 733, 1379, 733, 1379, 1380, 733, 733, 733, 733, 733, 733, 733, 732, 732, 732, 839, 840, 839, 840, 839, 840, 839, 840, 839, 840, 839, 840, 839, 840],
      [1380, 733, 1380, 1379, 1380, 733, 733, 733, 733, 733, 733, 733, 733, 732, 732, 732, 733, 733, 733, 839, 840, 839, 840, 839, 840, 839, 840, 839, 840, 839],
      [1379, 733, 733, 733, 1379, 1380, 733, 733, 733, 733, 733, 733, 733, 733, 733, 733, 733, 733, 733, 840, 839, 840, 839, 840, 839, 840, 839, 840, 839, 840],
      [733, 733, 733, 733, 733, 1379, 733, 733, 733, 733, 733, 733, 733, 733, 733, 733, 733, 733, 733, 839, 840, 839, 840, 839, 840, 839, 840, 839, 840, 839],
      [1379, 733, 733, 733, 1379, 733, 733, 733, 733, 733, 839, 840, 839, 840, 839, 840, 839, 840, 839, 840, 839, 840, 839, 840, 839, 840, 839, 840, 839, 840],
      [733, 1379, 733, 733, 1380, 1379, 733, 733, 733, 733, 733, 733, 733, 839, 840, 839, 840, 839, 840, 839, 840, 839, 840, 839, 840, 839, 840, 839, 840, 839],
      [1379, 733, 1379, 733, 1379, 733, 733, 733, 733, 733, 733, 733, 733, 733, 733, 733, 839, 840, 839, 840, 839, 840, 839, 840, 839, 840, 839, 840, 839, 840],
      [733, 1379, 733, 1379, 733, 733, 733, 733, 733, 733, 733, 733, 733, 733, 733, 733, 840, 839, 840, 839, 840, 839, 840, 839, 840, 839, 840, 839, 840, 839],
      [1379, 1380, 733, 1380, 733, 1380, 733, 733, 733, 733, 733, 733, 733, 733, 733, 733, 839, 840, 839, 840, 839, 840, 839, 840, 839, 840, 839, 840, 839, 840],
      [733, 1379, 1380, 733, 1380, 1379, 733, 733, 733, 733, 733, 733, 733, 733, 733, 839, 840, 839, 840, 839, 840, 839, 840, 839, 840, 839, 840, 839, 840, 839],
      [733, 733, 733, 733, 1379, 733, 733, 733, 733, 733, 733, 733, 733, 733, 733, 733, 733, 733, 733, 840, 839, 840, 839, 840, 839, 840, 839, 840, 839, 840],
      [1380, 733, 1380, 733, 733, 1379, 733, 733, 733, 733, 733, 733, 733, 733, 733, 733, 733, 733, 733, 839, 840, 839, 840, 839, 840, 839, 840, 839, 840, 839],
      [1379, 1380, 733, 1380, 733, 733, 733, 733, 733, 733, 733, 733, 733, 733, 733, 733, 733, 733, 733, 840, 839, 840, 839, 840, 839, 840, 839, 840, 839, 840],
      [1380, 733, 1380, 733, 733, 733, 733, 733, 733, 733, 733, 733, 733, 733, 733, 733, 733, 733, 733, 839, 840, 839, 840, 839, 840, 839, 840, 839, 840, 839]
    ],
    [
      [0, 0, 0, 0, 0, 0, 0, 0, 0, 0, 0, 0, 0, 0, 0, 0, 0, 0, 0, 0, 0, 0, 0, 0, 0, 0, 0, 0, 0, 0],
      [0, 0, 0, 0, 209, 0, 0, 0, 0, 0, 0, 0, 0, 0, 0, 0, 0, 0, 0, 0, 0, 0, 208, 0, 0, 0, 208, 0, 0, 0],
      [0, 0, 209, 0, 0, 0, 209, 0, 0, 0, 0, 0, 0, 0, 0, 0, 209, 0, 0, 0, 0, 0, 0, 0, 208, 0, 0, 0, 208, 0],
      [0, 0, 0, 209, 0, 0, 0, 209, 0, 0, 0, 0, 0, 0, 0, 0, 0, 0, 208, 0, 0, 208, 0, 0, 0, 208, 0, 0, 0, 208],
      [0, 209, 0, 0, 0, 209, 0, 0, 0, 0, 0, 0, 0, 0, 0, 0, 208, 0, 0, 0, 0, 0, 0, 208, 0, 0, 0, 208, 0, 0],
      [0, 0, 209, 0, 0, 0, 0, 0, 209, 0, 0, 50, 0, 0, 0, 0, 0, 209, 0, 0, 0, 0, 208, 0, 0, 0, 208, 0, 0, 208],
      [0, 0, 0, 0, 0, 0, 0, 0, 0, 0, 0, 0, 0, 0, 0, 0, 0, 0, 0, 208, 0, 0, 154, 0, 0, 0, 0, 154, 0, 0],
      [0, 209, 0, 0, 0, 209, 0, 0, 0, 0, 0, 0, 0, 0, 0, 0, 0, 0, 0, 0, 0, 208, 0, 0, 0, 208, 0, 0, 208, 0],
      [0, 0, 0, 209, 0, 0, 0, 209, 0, 50, 0, 0, 0, 0, 0, 0, 0, 0, 0, 0, 0, 0, 0, 208, 0, 0, 0, 208, 0, 0],
      [0, 0, 0, 0, 0, 0, 0, 0, 0, 0, 0, 0, 0, 0, 0, 0, 208, 0, 0, 0, 0, 0, 208, 0, 0, 0, 208, 0, 0, 208],
      [0, 0, 209, 0, 0, 0, 209, 0, 0, 0, 0, 0, 0, 474, 0, 474, 0, 0, 209, 0, 0, 0, 0, 0, 154, 0, 0, 0, 0, 154],
      [0, 0, 0, 0, 209, 0, 0, 0, 209, 0, 0, 0, 0, 33, 37, 32, 0, 208, 0, 0, 0, 0, 0, 0, 0, 0, 0, 0, 0, 0],
      [0, 0, 0, 0, 0, 0, 0, 0, 50, 34, 0, 0, 0, 32, 473, 34, 0, 0, 0, 208, 0, 0, 0, 0, 0, 0, 0, 0, 0, 0],
      [0, 0, 0, 0, 0, 0, 0, 33, 0, 0, 37, 0, 0, 0, 0, 0, 0, 0, 0, 0, 0, 0, 0, 0, 0, 0, 0, 0, 0, 0],
      [0, 0, 0, 0, 0, 0, 0, 0, 32, 0, 0, 0, 0, 0, 0, 0, 0, 0, 0, 0, 0, 0, 0, 0, 0, 0, 0, 0, 0, 0],
      [0, 0, 0, 0, 0, 0, 0, 33, 0, 0, 38, 0, 0, 0, 0, 0, 0, 0, 0, 0, 0, 0, 0, 0, 0, 0, 0, 0, 0, 0],
      [0, 0, 0, 0, 0, 0, 0, 0, 0, 36, 0, 0, 0, 36, 473, 33, 0, 0, 0, 0, 0, 0, 154, 0, 0, 0, 154, 0, 0, 0],
      [0, 0, 0, 0, 0, 0, 0, 0, 0, 0, 0, 0, 0, 32, 33, 40, 209, 0, 0, 0, 0, 0, 0, 0, 0, 0, 0, 0, 0, 0],
      [0, 0, 0, 0, 0, 0, 0, 0, 0, 0, 0, 0, 0, 474, 0, 474, 0, 0, 208, 0, 0, 0, 0, 0, 0, 0, 0, 0, 0, 0],
      [0, 209, 0, 0, 0, 0, 0, 0, 0, 0, 0, 0, 0, 0, 0, 0, 0, 208, 0, 0, 0, 0, 208, 0, 0, 0, 208, 0, 0, 208],
      [0, 0, 0, 209, 0, 0, 0, 209, 0, 0, 0, 50, 0, 0, 0, 0, 209, 0, 0, 0, 0, 0, 0, 0, 208, 0, 0, 0, 208, 0],
      [0, 0, 0, 0, 0, 0, 209, 0, 0, 0, 0, 0, 0, 0, 0, 0, 0, 0, 0, 0, 0, 0, 208, 0, 0, 208, 0, 0, 0, 208],
      [0, 0, 0, 0, 0, 0, 0, 0, 209, 0, 0, 0, 0, 0, 0, 0, 0, 208, 0, 0, 0, 0, 0, 208, 0, 0, 0, 208, 0, 0],
      [0, 0, 0, 0, 0, 0, 0, 0, 0, 50, 0, 0, 0, 0, 0, 0, 0, 0, 0, 208, 0, 0, 0, 0, 154, 0, 0, 0, 154, 0],
      [0, 0, 0, 0, 209, 0, 0, 0, 0, 0, 0, 0, 0, 0, 0, 0, 209, 0, 0, 0, 0, 0, 0, 0, 0, 0, 0, 0, 0, 0],
      [0, 0, 0, 0, 0, 0, 209, 0, 0, 0, 0, 0, 0, 0, 0, 0, 0, 0, 208, 0, 0, 208, 0, 0, 0, 208, 0, 0, 208, 0],
      [0, 0, 0, 209, 0, 0, 0, 0, 209, 0, 0, 0, 0, 0, 0, 0, 0, 0, 0, 0, 0, 0, 0, 208, 0, 0, 0, 208, 0, 0],
      [0, 209, 0, 0, 0, 0, 0, 0, 0, 0, 0, 50, 0, 0, 0, 0, 0, 0, 0, 0, 0, 0, 208, 0, 0, 0, 208, 0, 0, 208],
      [0, 0, 0, 0, 0, 0, 0, 0, 0, 0, 0, 0, 0, 0, 0, 0, 0, 0, 0, 0, 0, 0, 0, 0, 208, 0, 0, 0, 208, 0],
      [0, 0, 0, 0, 0, 0, 0, 0, 0, 0, 0, 0, 0, 0, 0, 0, 0, 0, 0, 0, 0, 0, 0, 0, 0, 0, 0, 0, 0, 0]
    ]
  ],
  "legend": {"732": "grass", "733": "bog", "839": "meadow", "840": "meadow variant", "0": "overlay"},
  "spawns": {"player": {"x": 27, "y": 14}},
  "exits": {"west": {"tiles": [[0, 13], [0, 14], [0, 15]], "destination": "Great_Open_Bog", "entryPoint": "east"}, "east": {"tiles": [[29, 13], [29, 14], [29, 15]], "destination": "Oak_Wood", "entryPoint": "west"}},
 "entries": {"west": {"x": 1, "yFromSource": true, "y": 14}, "east": {"x": 28, "yFromSource": true, "y": 14}, "north": {"x": 15, "yFromSource": false, "y": 2}, "south": {"x": 15, "yFromSource": false, "y": 27}}
}
