{
  "name": "d3_open_sea",
  "width": 36,
  "height": 36,
  "layers": [
    [
      [1625,1679,1625,1679,1625,1679,1625,1679,1625,1679,1625,1679,1625,1679,1625,1679,1625,1679,1625,1679,1625,1679,1625,1679,1625,1679,1625,1679,1625,1679,1625,1679,1625,1679,1625,1679],
      [1679,1625,1679,1625,1679,1625,1679,1625,1679,1625,1679,1625,1679,1625,1679,1625,1679,1625,1679,1625,1679,1625,1679,1625,1679,1625,1679,1625,1679,1625,1679,1625,1679,1625,1679,1625],
      [1625,1679,1625,1679,1625,1679,1625,1679,1625,1679,1625,1679,1625,1679,1625,1679,1625,1679,1625,1679,1625,1679,1625,1679,1625,1679,1625,1679,1625,1679,1625,1679,1625,1679,1625,1679],
      [1679,1625,1679,1625,1679,1625,1679,1625,1679,1625,1679,1625,1679,1625,1679,1625,1679,1625,1679,1625,1679,1625,1679,1625,1679,1625,1679,1625,1679,1625,1679,1625,1679,1625,1679,1625],
      [1625,1679,1625,1679,1625,1679,1625,1679,1625,1679,1625,1679,1625,1679,1625,1679,1625,1679,1625,1679,1625,1679,1625,1679,1625,1679,1625,1679,1625,1679,1625,1679,1625,1679,1625,1679],
      [1679,1625,1679,1625,1679,1625,1679,1625,1679,1625,1679,1625,1679,1625,1679,1625,1679,1625,1679,1625,1679,1625,1679,1625,1679,1625,1679,1625,1679,1625,1679,1625,1679,1625,1679,1625],
      [1625,1679,1625,1679,1625,1679,1625,1679,1625,1679,1625,1679,1625,1679,1625,1679,1625,1679,1625,1679,1625,1679,1625,1679,1625,1679,1625,1679,1625,1679,1625,1679,1625,1679,1625,1679],
      [1679,1625,1679,1625,1679,1625,1679,1625,1679,1625,1679,1625,1679,1625,1679,1625,1679,1625,1679,1625,1679,1625,1679,1625,1679,1625,1679,1625,1679,1625,1679,1625,1679,1625,1679,1625],
      [1625,1679,1625,1679,1625,1679,1625,1679,1625,1679,1625,1679,1625,1679,1625,1679,1625,1679,1625,1679,1625,1679,1625,1679,1625,1679,1625,1679,1625,1679,1625,1679,1625,1679,1625,1679],
      [1679,1625,1679,1625,1679,1625,1679,1625,1679,1625,1679,1625,1679,1625,1679,1625,1679,1625,1679,1625,1679,1625,1679,1625,1679,1625,1679,1625,1679,1625,1679,1625,1679,1625,1679,1625],
      [1625,1679,1625,1679,1625,1679,1625,1679,1625,1679,1625,1679,1625,1679,1625,1679,1625,1679,1625,1679,1625,1679,1625,1679,1625,1679,1625,1679,1625,1679,1625,1679,1625,1679,1625,1679],
      [1679,1625,1679,1625,1679,1625,1679,1625,1679,1625,1679,1625,1679,1625,1679,1625,1679,1625,1679,1625,1679,1625,1679,1625,1679,1625,1679,1625,1679,1625,1679,1625,1679,1625,1679,1625],
      [1625,1679,1625,1679,1625,1679,1625,1679,1625,1679,1625,1679,1625,1679,1625,1679,1625,1679,1625,1679,1625,1679,1625,1679,1625,1679,1625,1679,1625,1679,1625,1679,1625,1679,1625,1679],
      [1679,1625,1679,1625,1679,1625,1679,1625,1679,1625,1679,1625,1679,1625,1679,1625,1679,1625,1679,1625,1679,1625,1679,1625,1679,1625,1679,1625,1679,1625,1679,1625,1679,1625,1679,1625],
      [1625,1679,1625,1679,1625,1679,1625,1679,1625,1679,1625,1679,1625,1679,1625,1679,1625,1679,1625,1679,1625,1679,1625,1679,1625,1679,1625,1679,1625,1679,1625,1679,1625,1679,1625,1679],
      [1679,1625,1679,1625,1679,1625,1679,1625,1679,1625,1679,1625,1679,1625,1679,1625,1679,1625,1679,1625,1679,1625,1679,1625,1679,1625,1679,1625,1679,1625,1679,1625,1679,1625,1679,1625],
      [1625,1679,1625,1679,1625,1679,1625,1679,1625,1679,1625,1679,1625,1679,1625,1679,1625,1679,1625,1679,1625,1679,1625,1679,1625,1679,1625,1679,1625,1679,1625,1679,1625,1679,1625,1679],
      [1679,1625,1679,1625,1679,1625,1679,1625,1679,1625,1679,1625,1679,1625,1679,1625,1679,1625,1679,1625,1679,1625,1679,1625,1679,1625,1679,1625,1679,1625,1679,1625,1679,1625,1679,1625],
      [1625,1679,1625,1679,1625,1679,1625,1679,1625,1679,1625,1679,1625,1679,1625,1679,1625,1679,1625,1679,1625,1679,1625,1679,1625,1679,1625,1679,1625,1679,1625,1679,1625,1679,1625,1679],
      [1679,1625,1679,1625,1679,1625,1679,1625,1679,1625,1679,1625,1679,1625,1679,1625,1679,1625,1679,1625,1679,1625,1679,1625,1679,1625,1679,1625,1679,1625,1679,1625,1679,1625,1679,1625],
      [1625,1679,1625,1679,1625,1679,1625,1679,1625,1679,1625,1679,1625,1679,1625,1679,1625,1679,1625,1679,1625,1679,1625,1679,1625,1679,1625,1679,1625,1679,1625,1679,1625,1679,1625,1679],
      [1679,1625,1679,1625,1679,1625,1679,1625,1679,1625,1679,1625,1679,1625,1679,1625,1679,1625,1679,1625,1679,1625,1679,1625,1679,1625,1679,1625,1679,1625,1679,1625,1679,1625,1679,1625],
      [1625,1679,1625,1679,1625,1679,1625,1679,1625,1679,1625,1679,1625,1679,1625,1679,1625,1679,1625,1679,1625,1679,1625,1679,1625,1679,1625,1679,1625,1679,1625,1679,1625,1679,1625,1679],
      [1679,1625,1679,1625,1679,1625,1679,1625,1679,1625,1679,1625,1679,1625,1679,1625,1679,1625,1679,1625,1679,1625,1679,1625,1679,1625,1679,1625,1679,1625,1679,1625,1679,1625,1679,1625],
      [1625,1679,1625,1679,1625,1679,1625,1679,1625,1679,1625,1679,1625,1679,1625,1679,1625,1679,1625,1679,1625,1679,1625,1679,1625,1679,1625,1679,1625,1679,1625,1679,1625,1679,1625,1679],
      [1679,1625,1679,1625,1679,1625,1679,1625,1679,1625,1679,1625,1679,1625,1679,1625,1679,1625,1679,1625,1679,1625,1679,1625,1679,1625,1679,1625,1679,1625,1679,1625,1679,1625,1679,1625],
      [1625,1679,1625,1679,1625,1679,1625,1679,1625,1679,1625,1679,1625,1679,1625,1679,1625,1679,1625,1679,1625,1679,1625,1679,1625,1679,1625,1679,1625,1679,1625,1679,1625,1679,1625,1679],
      [1679,1625,1679,1625,1679,1625,1679,1625,1679,1625,1679,1625,1679,1625,1679,1625,1679,1625,1679,1625,1679,1625,1679,1625,1679,1625,1679,1625,1679,1625,1679,1625,1679,1625,1679,1625],
      [1625,1679,1625,1679,1625,1679,1625,1679,1625,1679,1625,1679,1625,1679,1625,1679,1625,1679,1625,1679,1625,1679,1625,1679,1625,1679,1625,1679,1625,1679,1625,1679,1625,1679,1625,1679],
      [1679,1625,1679,1625,1679,1625,1679,1625,1679,1625,1679,1625,1679,1625,1679,1625,1679,1625,1679,1625,1679,1625,1679,1625,1679,1625,1679,1625,1679,1625,1679,1625,1679,1625,1679,1625],
      [1625,1679,1625,1679,1625,1679,1625,1679,1625,1679,1625,1679,1625,1679,1625,1679,1625,1679,1625,1679,1625,1679,1625,1679,1625,1679,1625,1679,1625,1679,1625,1679,1625,1679,1625,1679],
      [1679,1625,1679,1625,1679,1625,1679,1625,1679,1625,1679,1625,1679,1625,1679,1625,1679,1625,1679,1625,1679,1625,1679,1625,1679,1625,1679,1625,1679,1625,1679,1625,1679,1625,1679,1625],
      [1625,1679,1625,1679,1625,1679,1625,1679,1625,1679,1625,1679,1625,1679,1625,1679,1625,1679,1625,1679,1625,1679,1625,1679,1625,1679,1625,1679,1625,1679,1625,1679,1625,1679,1625,1679],
      [1679,1625,1679,1625,1679,1625,1679,1625,1679,1625,1679,1625,1679,1625,1679,1625,1679,1625,1679,1625,1679,1625,1679,1625,1679,1625,1679,1625,1679,1625,1679,1625,1679,1625,1679,1625],
      [1625,1679,1625,1679,1625,1679,1625,1679,1625,1679,1625,1679,1625,1679,1625,1679,1625,1679,1625,1679,1625,1679,1625,1679,1625,1679,1625,1679,1625,1679,1625,1679,1625,1679,1625,1679],
      [1679,1625,1679,1625,1679,1625,1679,1625,1679,1625,1679,1625,1679,1625,1679,1625,1679,1625,1679,1625,1679,1625,1679,1625,1679,1625,1679,1625,1679,1625,1679,1625,1679,1625,1679,1625]
    ],
    [
      [0,0,0,0,0,0,0,0,0,0,0,0,0,0,0,0,0,0,0,0,0,0,0,0,0,0,0,0,0,0,0,0,0,0,0,0],
      [0,0,0,0,0,0,0,0,0,0,0,0,0,0,0,0,0,0,0,0,0,0,0,0,0,0,0,0,0,0,0,0,0,0,0,0],
      [0,0,0,0,0,0,0,0,0,0,0,0,0,0,0,0,0,0,0,0,0,0,0,0,0,0,0,0,0,0,0,0,0,0,0,0],
      [0,0,0,0,0,0,0,0,0,0,0,0,0,0,0,0,0,0,0,0,0,0,0,0,0,0,0,0,0,0,0,0,0,0,0,0],
      [0,0,0,0,0,0,0,0,0,0,0,0,0,0,0,0,0,0,0,0,0,0,0,0,0,0,0,0,0,0,0,0,0,0,0,0],
      [0,0,0,0,0,0,0,0,0,0,0,0,0,0,0,0,0,0,0,0,0,0,0,0,0,0,0,0,0,0,0,0,0,0,0,0],
      [0,0,0,0,0,0,0,0,0,0,0,0,0,0,0,0,0,0,0,0,0,0,0,0,0,0,0,0,0,0,0,0,0,0,0,0],
      [0,0,0,0,0,0,0,0,0,0,0,0,0,0,0,0,0,0,0,0,0,0,0,0,0,0,0,0,0,0,0,0,0,0,0,0],
      [0,0,0,0,0,0,0,0,0,0,0,0,0,0,0,0,0,0,0,0,0,0,0,0,0,0,0,0,0,0,0,0,0,0,0,0],
      [0,0,0,0,0,0,0,0,0,0,0,0,0,0,0,0,0,0,0,0,0,0,0,0,0,0,0,0,0,0,0,0,0,0,0,0],
      [0,0,0,0,0,0,0,0,0,0,0,0,0,0,0,0,0,0,0,0,0,0,0,0,0,0,0,0,0,0,0,0,0,0,0,0],
      [0,0,0,0,0,0,0,0,0,0,0,0,0,0,0,0,0,0,0,0,0,0,0,0,0,0,0,0,0,0,0,0,0,0,0,0],
      [0,0,0,0,0,0,0,0,0,0,0,0,0,0,0,0,0,0,0,0,0,0,0,0,0,0,0,0,0,0,0,0,0,0,0,0],
      [0,0,0,0,0,0,0,0,0,0,0,0,0,0,0,0,0,0,0,0,0,0,0,0,0,0,0,0,0,0,0,0,0,0,0,0],
      [0,0,0,0,0,0,0,0,0,0,0,0,0,0,0,0,0,0,0,0,0,0,0,0,0,0,0,0,0,0,0,0,0,0,0,0],
      [0,0,0,0,0,0,0,0,0,0,0,0,0,0,0,0,0,0,0,0,0,0,0,0,0,0,0,0,0,0,0,0,0,0,0,0],
      [0,0,0,0,0,0,0,0,0,0,0,0,0,0,0,0,0,0,0,0,0,0,0,0,0,0,0,0,0,0,0,0,0,0,0,0],
      [0,0,0,0,0,0,0,0,0,0,0,0,0,0,0,0,0,0,0,0,0,0,0,0,0,0,0,0,0,0,0,0,0,0,0,0],
      [0,0,0,0,0,0,0,0,0,0,0,0,0,0,0,0,0,0,0,0,0,0,0,0,0,0,0,0,0,0,0,0,0,0,0,0],
      [0,0,0,0,0,0,0,0,0,0,0,0,0,0,0,0,0,0,0,0,0,0,0,0,0,0,0,0,0,0,0,0,0,0,0,0],
      [0,0,0,0,0,0,0,0,0,0,0,0,0,0,0,0,0,0,0,0,0,0,0,0,0,0,0,0,0,0,0,0,0,0,0,0],
      [0,0,0,0,0,0,0,0,0,0,0,0,0,0,0,0,0,0,0,0,0,0,0,0,0,0,0,0,0,0,0,0,0,0,0,0],
      [0,0,0,0,0,0,0,0,0,0,0,0,0,0,0,0,0,0,0,0,0,0,0,0,0,0,0,0,0,0,0,0,0,0,0,0],
      [0,0,0,0,0,0,0,0,0,0,0,0,0,0,0,0,0,0,0,0,0,0,0,0,0,0,0,0,0,0,0,0,0,0,0,0],
      [0,0,0,0,0,0,0,0,0,0,0,0,0,0,0,0,0,0,0,0,0,0,0,0,0,0,0,0,0,0,0,0,0,0,0,0],
      [0,0,0,0,0,0,0,0,0,0,0,0,0,0,0,0,0,0,0,0,0,0,0,0,0,0,0,0,0,0,0,0,0,0,0,0],
      [0,0,0,0,0,0,0,0,0,0,0,0,0,0,0,0,0,0,0,0,0,0,0,0,0,0,0,0,0,0,0,0,0,0,0,0],
      [0,0,0,0,0,0,0,0,0,0,0,0,0,0,0,0,0,0,0,0,0,0,0,0,0,0,0,0,0,0,0,0,0,0,0,0],
      [0,0,0,0,0,0,0,0,0,0,0,0,0,0,0,0,0,0,0,0,0,0,0,0,0,0,0,0,0,0,0,0,0,0,0,0],
      [0,0,0,0,0,0,0,0,0,0,0,0,0,0,0,0,0,0,0,0,0,0,0,0,0,0,0,0,0,0,0,0,0,0,0,0],
      [0,0,0,0,0,0,0,0,0,0,0,0,0,0,0,0,0,0,0,0,0,0,0,0,0,0,0,0,0,0,0,0,0,0,0,0],
      [0,0,0,0,0,0,0,0,0,0,0,0,0,0,0,0,0,0,0,0,0,0,0,0,0,0,0,0,0,0,0,0,0,0,0,0],
      [0,0,0,0,0,0,0,0,0,0,0,0,0,0,0,0,0,0,0,0,0,0,0,0,0,0,0,0,0,0,0,0,0,0,0,0],
      [0,0,0,0,0,0,0,0,0,0,0,0,0,0,0,0,0,0,0,0,0,0,0,0,0,0,0,0,0,0,0,0,0,0,0,0],
      [0,0,0,0,0,0,0,0,0,0,0,0,0,0,0,0,0,0,0,0,0,0,0,0,0,0,0,0,0,0,0,0,0,0,0,0],
      [0,0,0,0,0,0,0,0,0,0,0,0,0,0,0,0,0,0,0,0,0,0,0,0,0,0,0,0,0,0,0,0,0,0,0,0]
    ]
  ],
  "hasCliffs": false,
  "legend": {
    "0": "overlay",
    "1625": "water",
    "1679": "water"
  },
  "spawns": {
    "player": { "x": 3, "y": 18 }
  },
  "exits": {
    "west": {
      "tiles": [[0,6],[0,7],[0,8],[0,9],[0,10],[0,11],[0,12],[0,13],[0,14],[0,15],[0,16],[0,17],[0,18],[0,19],[0,20],[0,21],[0,22],[0,23],[0,24],[0,25],[0,26],[0,27],[0,28],[0,29]],
      "destination": "d3_sea",
      "entryPoint": "east"
    }
  },
  "entries": {
    "east": { "x": 32, "y": 18, "yFromSource": true }
  },
  "border": {
    "openCols": [],
    "openRows": [6,7,8,9,10,11,12,13,14,15,16,17,18,19,20,21,22,23,24,25,26,27,28,29]
  }
}
