{
  "seed": "8yriob",
  "type": 0,
  "width": 40,
  "height": 40,
  "layers": [
    [
      [733,733,733,733,733,733,733,733,733,733,733,733,733,733,733,733,733,733,733,733,733,733,733,733,733,733,733,733,733,733,733,733,733,733,733,733,733,733,733,733],
      [733,733,733,733,733,733,733,733,733,733,733,733,733,733,733,733,733,733,733,733,733,733,733,733,733,733,733,733,733,733,733,733,733,733,733,733,733,733,733,733],
      [733,733,733,733,733,733,733,733,733,733,733,733,733,733,733,733,733,733,733,733,733,733,733,733,733,733,733,733,733,733,733,733,733,733,733,733,733,733,733,733],
      [733,733,733,733,733,733,733,733,733,733,733,733,733,733,733,733,733,733,733,733,733,733,733,733,733,733,733,733,733,733,733,733,733,733,733,733,733,733,733,733],
      [733,733,733,733,733,733,733,733,733,733,733,733,733,733,733,733,733,733,733,733,733,733,733,733,733,733,733,733,733,733,733,733,733,733,733,733,733,733,733,733],
      [733,733,733,733,733,733,733,733,733,733,733,733,733,733,733,733,733,733,733,733,733,733,733,733,733,733,733,733,733,733,733,733,733,733,733,733,733,733,733,733],
      [733,733,733,733,733,733,733,733,733,733,733,733,733,733,733,733,733,733,733,733,733,733,733,733,733,733,733,733,733,733,733,733,733,733,733,733,733,733,733,733],
      [733,733,733,733,733,733,733,733,733,733,733,733,733,733,733,733,733,733,733,733,733,733,733,733,733,733,733,733,733,733,733,733,733,733,733,733,733,733,733,733],
      [733,733,733,733,733,733,733,733,733,733,733,733,733,733,733,733,733,733,733,733,733,733,733,733,733,733,733,733,733,733,733,733,733,733,733,733,733,733,733,733],
      [733,733,733,733,733,733,733,733,733,733,733,733,733,733,733,733,733,733,733,733,733,733,733,733,733,733,733,733,733,733,733,733,733,733,733,733,733,733,733,733],
      [733,733,733,733,733,733,733,733,733,733,733,733,733,733,733,733,733,733,733,733,733,733,733,733,733,733,733,733,733,733,733,733,733,733,733,733,733,733,733,733],
      [733,733,733,733,733,733,733,733,733,733,733,733,733,733,733,733,733,733,733,733,733,733,733,733,733,733,733,733,733,733,733,733,733,733,733,733,733,733,733,733],
      [733,733,733,733,733,733,733,733,733,733,733,733,733,733,733,733,733,733,733,733,733,733,733,733,733,733,733,733,733,733,733,733,733,733,733,733,733,733,733,733],
      [733,733,733,733,733,733,733,733,733,733,733,733,733,733,733,733,733,733,733,733,733,733,733,733,733,733,733,733,733,733,733,733,733,733,733,733,733,733,733,733],
      [733,733,733,733,733,733,733,733,733,733,733,733,733,733,733,733,733,733,733,733,733,733,733,733,733,733,733,733,733,733,733,733,733,733,733,733,733,733,733,733],
      [733,733,733,733,733,733,733,733,733,733,733,733,733,733,733,733,733,733,733,733,733,733,733,733,733,733,733,733,733,733,733,733,733,733,733,733,733,733,733,733],
      [733,733,733,733,733,733,733,733,733,733,733,733,733,733,733,733,733,733,733,733,733,733,733,733,733,733,733,733,733,733,733,733,733,733,733,733,733,733,733,733],
      [733,733,733,733,733,733,733,733,733,733,733,733,733,733,733,733,733,733,733,733,733,733,733,733,733,733,733,733,733,733,733,733,733,733,733,733,733,733,733,733],
      [733,733,733,733,733,733,733,733,733,733,733,733,733,733,733,733,733,733,733,733,733,733,733,733,733,733,733,733,733,733,733,733,733,733,733,733,733,733,733,733],
      [733,733,733,733,733,733,733,733,733,733,733,733,733,733,733,733,733,733,733,733,733,733,733,733,733,733,733,733,733,733,733,733,733,733,733,733,733,733,733,733],
      [733,733,733,733,733,733,733,733,733,733,733,733,733,733,733,733,733,733,733,733,733,733,733,733,733,733,733,733,733,733,733,733,733,733,733,733,733,733,733,733],
      [733,733,733,733,733,733,733,733,733,733,733,733,733,733,733,733,733,733,733,733,733,733,733,733,733,733,733,733,733,733,733,733,733,733,733,733,733,733,733,733],
      [733,733,733,733,733,733,733,733,733,733,733,733,733,733,733,733,733,733,733,733,733,733,733,733,733,733,733,733,733,733,733,733,733,733,733,733,733,733,733,733],
      [733,733,733,733,733,733,733,733,733,733,733,733,733,733,733,733,733,733,733,733,733,733,733,733,733,733,733,733,733,733,733,733,733,733,733,733,733,733,733,733],
      [733,733,733,733,733,733,733,733,733,733,733,733,733,733,733,733,733,733,733,733,733,733,733,733,733,733,733,733,733,733,733,733,733,733,733,733,733,733,733,733],
      [733,733,733,733,733,733,733,733,733,733,733,733,733,733,733,733,733,733,733,733,733,733,733,733,733,733,733,733,733,733,733,733,733,733,733,733,733,733,733,733],
      [733,733,733,733,733,733,733,733,733,733,733,733,733,733,733,733,733,733,733,733,733,733,733,733,733,733,733,733,733,733,733,733,733,733,733,733,733,733,733,733],
      [733,733,733,733,733,733,733,733,733,733,733,733,733,733,733,733,733,733,733,733,733,733,733,733,733,733,733,733,733,733,733,733,733,733,733,733,733,733,733,733],
      [733,733,733,733,733,733,733,733,733,733,733,733,733,733,733,733,733,733,733,733,733,733,733,733,733,733,733,733,733,733,733,733,733,733,733,733,733,733,733,733],
      [733,733,733,733,733,733,733,733,733,733,733,733,733,733,733,733,733,733,733,733,733,733,733,733,733,733,733,733,733,733,733,733,733,733,733,733,733,733,733,733],
      [733,733,733,733,733,733,733,733,733,733,733,733,733,733,733,733,733,733,733,733,733,733,733,733,733,733,733,733,733,733,733,733,733,733,733,733,733,733,733,733],
      [733,733,733,733,733,733,733,733,733,733,733,733,733,733,733,733,733,733,733,733,733,733,733,733,733,733,733,733,733,733,733,733,733,733,733,733,733,733,733,733],
      [733,733,733,733,733,733,733,733,733,733,733,733,733,733,733,733,733,733,733,733,733,733,733,733,733,733,733,733,733,733,733,733,733,733,733,733,733,733,733,733],
      [733,733,733,733,733,733,733,733,733,733,733,733,733,733,733,733,733,733,733,733,733,733,733,733,733,733,733,733,733,733,733,733,733,733,733,733,733,733,733,733],
      [733,733,733,733,733,733,733,733,733,733,733,733,733,733,733,733,733,733,733,733,733,733,733,733,733,733,733,733,733,733,733,733,733,733,733,733,733,733,733,733],
      [733,733,733,733,733,733,733,733,733,733,733,733,733,733,733,733,733,733,733,733,733,733,733,733,733,733,733,733,733,733,733,733,733,733,733,733,733,733,733,733],
      [733,733,733,733,733,733,733,733,733,733,733,733,733,733,733,733,733,733,733,733,733,733,733,733,733,733,733,733,733,733,733,733,733,733,733,733,733,733,733,733],
      [733,733,733,733,733,733,733,733,733,733,733,733,733,733,733,733,733,733,733,733,733,733,733,733,733,733,733,733,733,733,733,733,733,733,733,733,733,733,733,733],
      [733,733,733,733,733,733,733,733,733,733,733,733,733,733,733,733,733,733,733,733,733,733,733,733,733,733,733,733,733,733,733,733,733,733,733,733,733,733,733,733],
      [733,733,733,733,733,733,733,733,733,733,733,733,733,733,733,733,733,733,733,733,733,733,733,733,733,733,733,733,733,733,733,733,733,733,733,733,733,733,733,733]
    ],
    [
      [0,0,0,0,0,0,0,0,0,0,0,0,0,0,0,0,0,0,0,0,0,0,0,0,0,0,0,0,0,0,0,0,0,0,0,0,0,0,0,0],
      [0,1116,1120,1120,1120,1120,1120,1120,1120,1120,1120,1120,1120,1120,1120,1120,1120,1120,1120,1120,1120,1120,1120,1120,1120,1120,1120,1120,1120,1120,1120,1120,1120,1120,1120,1120,1120,1120,1117,0],
      [0,1120,1055,1056,1056,1056,678,1056,1056,1055,1055,678,678,678,678,1056,1055,1055,678,678,1056,1055,1056,1055,678,1056,678,1056,1055,1056,678,1056,1055,1056,678,1056,1056,1055,1120,0],
      [0,1120,1056,1056,1056,1055,1056,1056,1056,678,1056,1056,1056,1055,1055,1055,1056,678,1056,1055,1055,1055,1056,678,1055,1055,1056,1055,1056,1056,1056,678,678,678,1056,1055,1056,678,1120,0],
      [0,1120,1056,1055,1056,1056,1055,1056,1055,678,1056,678,1055,1055,1056,1055,1056,1055,678,1056,1055,678,1056,1055,678,678,1056,1056,1055,1055,678,678,678,678,1055,678,1056,1055,1120,0],
      [0,1120,1055,1055,678,1056,1056,1056,678,1056,1055,1055,1056,1056,678,1055,1055,1055,678,1055,1055,1055,678,678,678,1055,678,1055,678,678,678,678,678,1056,1055,1055,678,1055,1120,0],
      [0,1120,678,678,678,1055,678,678,1055,678,678,1056,1055,678,678,1056,1056,1055,678,1056,678,1056,1056,678,1056,678,1056,1055,678,1056,678,1056,1055,678,1055,1055,1056,1056,1120,0],
      [0,1120,1056,1056,678,678,1056,1056,1055,678,1055,1055,1056,1056,678,1055,1056,678,1056,1056,1056,1056,678,1056,678,1056,1055,1056,678,678,678,1055,1055,1055,1055,1055,1055,678,1120,0],
      [0,1120,1055,678,1056,678,678,678,1055,678,678,1055,1056,678,678,678,1055,678,678,1055,1055,678,678,1055,1055,678,678,1055,678,1055,678,1056,1056,678,1056,678,678,1056,1120,0],
      [0,1120,678,1056,678,678,678,678,1055,1055,1056,1056,678,678,1055,678,1055,1055,1056,678,678,1055,678,1055,678,1055,1055,1056,1055,678,1056,1056,678,678,1055,678,1055,1055,1120,0],
      [0,1120,678,1056,1056,678,678,1056,678,678,678,1055,1055,678,1055,1056,678,1055,678,678,678,1055,1056,1055,1055,1055,1055,678,678,678,678,1055,1055,1055,1056,678,1056,1056,1120,0],
      [0,1120,1056,678,678,1055,1055,1055,678,1056,678,678,678,1055,1056,1055,1056,1055,1056,1056,678,1055,1056,1056,1056,1056,678,1056,1056,678,1056,678,1056,1056,1056,1055,678,1056,1120,0],
      [0,1120,678,1055,1055,1056,1055,1055,678,678,678,678,1055,678,678,678,1056,1056,1056,1055,1055,1056,678,678,678,1055,1056,1055,1056,678,678,678,1055,1055,1055,1055,1055,1055,1120,0],
      [0,1120,678,1056,1055,1055,1056,1056,678,1056,1056,678,1055,678,1056,1055,1055,1056,1056,1055,678,1055,1055,1056,1056,1056,1056,678,1055,1056,1056,1055,1055,678,1055,678,678,1056,1120,0],
      [0,1120,1055,1056,1056,1056,678,678,1055,1056,1056,1056,1055,1056,1055,1055,1056,678,1055,678,1056,1055,678,1056,1056,1055,678,678,1055,1055,678,678,1056,678,678,678,1056,678,1120,0],
      [0,1120,1055,1055,678,1055,678,678,1055,678,678,678,678,1056,1056,1056,678,1055,678,1055,1055,1056,678,678,1056,678,678,1055,678,1056,1056,678,678,678,1056,678,1056,1055,1120,0],
      [0,1120,678,1055,678,1055,1056,1055,1055,1056,1055,678,1056,678,1055,1055,678,678,1056,1056,678,1056,1056,1056,1055,678,678,678,678,678,1056,1056,1055,1055,678,678,1120,1120,1119,0],
      [0,1120,1056,1055,1056,1120,1120,1120,1120,1120,1120,1120,1120,1120,1120,1120,1120,1055,678,1056,1055,1055,1056,1056,1055,678,1120,1120,1120,1120,1120,1120,1120,1055,1055,1120,1119,0,0,0],
      [0,1120,678,1055,1120,1119,0,0,0,0,0,0,0,0,0,0,1118,1120,1055,1055,1056,1056,678,1056,1056,1120,1119,0,0,0,0,0,1118,1120,1120,1119,0,0,0,0],
      [0,1120,1120,1120,1119,0,0,0,0,0,0,0,0,0,0,0,0,1118,1120,678,1056,678,1120,1120,1120,1119,0,0,0,0,0,0,0,0,0,0,0,0,0,0],
      [0,1120,1119,0,0,0,0,0,0,0,0,0,0,0,0,0,0,0,1118,1120,1120,1120,1119,0,0,0,0,0,0,0,0,0,0,0,0,0,0,0,0,0],
      [0,1120,0,0,0,0,0,0,0,0,0,0,0,0,0,0,0,0,0,0,0,0,0,0,0,0,0,0,0,0,0,0,0,0,0,0,0,0,0,0],
      [0,1121,0,0,0,0,0,0,0,0,0,0,0,0,0,0,0,0,0,0,0,0,0,0,0,0,0,0,0,0,0,0,0,0,0,0,0,0,0,0],
      [0,0,0,0,0,0,0,0,0,0,0,0,0,0,0,0,0,0,0,0,0,0,0,0,0,0,0,0,0,0,0,0,0,0,0,0,0,0,0,0],
      [0,0,0,0,0,0,0,0,1120,1120,1120,1120,1120,0,0,0,0,0,0,0,0,0,0,0,0,0,0,0,0,0,0,0,0,0,0,0,0,0,0,0],
      [0,0,0,0,0,0,0,0,1120,1120,1120,1120,1120,1120,0,0,0,0,0,0,0,0,0,0,0,0,0,0,0,0,0,0,0,0,0,0,0,0,0,0],
      [0,0,0,0,0,0,0,0,1120,1120,1120,1120,1120,1120,0,0,0,0,0,0,0,0,0,0,0,0,0,0,0,0,0,0,0,0,0,0,0,0,0,0],
      [0,0,0,0,0,0,0,0,1120,1120,1120,1120,1120,1120,1120,0,0,0,0,0,0,0,0,0,0,0,0,0,0,0,0,0,0,0,0,0,0,0,0,0],
      [0,0,0,0,0,0,0,1120,1120,1120,1120,1120,1120,1120,0,0,0,0,0,0,0,0,0,0,0,0,0,0,0,0,0,0,0,0,0,0,0,0,0,0],
      [0,0,0,0,0,0,1120,1120,1120,1120,1120,1120,1120,0,0,0,0,0,0,0,0,0,0,0,0,0,0,0,0,0,0,0,0,0,0,0,0,0,0,0],
      [0,0,0,0,0,0,0,1120,1120,1120,1120,1120,0,0,0,0,0,0,0,0,0,0,0,0,0,0,0,0,0,0,0,0,0,0,0,0,0,0,0,0],
      [0,0,0,0,0,0,0,0,0,0,1120,0,0,0,0,0,0,0,0,1116,1117,0,0,0,0,0,0,0,0,0,0,0,0,0,0,0,0,0,0,0],
      [0,0,0,0,0,0,0,0,0,0,0,0,0,0,0,0,0,0,0,1120,1120,0,0,0,0,0,0,0,0,0,0,0,0,0,0,0,0,0,0,0],
      [0,1116,1117,0,0,0,0,0,0,0,0,0,0,0,0,0,0,0,0,1120,1120,1117,0,0,0,0,0,0,0,0,0,0,0,0,0,0,0,0,0,0],
      [0,1120,1120,1117,0,0,0,0,0,0,0,0,0,0,0,0,0,0,1116,1120,1056,1120,1117,0,0,0,0,0,0,0,0,0,0,0,0,0,0,1116,1117,0],
      [0,1120,1055,1120,1117,0,0,0,0,0,0,0,0,0,0,0,0,1116,1120,1055,1056,1056,1120,1120,1117,0,0,0,0,0,0,0,0,0,0,0,1116,1120,1120,0],
      [0,1120,678,678,1120,0,0,0,0,0,0,0,0,0,0,0,1116,1120,1055,1055,1055,678,1056,1056,1120,1120,1117,0,0,0,0,0,0,0,0,1116,1120,1056,1120,0],
      [0,1120,1056,1055,1120,1120,1120,1120,1120,1120,1120,1120,1117,0,0,1116,1120,1056,678,1056,1055,1055,1055,678,1056,678,1120,1120,1120,1120,1120,1120,1120,1120,1120,1120,1056,1055,1120,0],
      [0,1118,1120,1120,1120,1120,1120,1120,1120,1120,1120,1120,1119,0,0,1118,1120,1120,1120,1120,1120,1120,1120,1120,1120,1120,1120,1120,1120,1120,1120,1120,1120,1120,1120,1120,1120,1120,1119,0],
      [0,0,0,0,0,0,0,0,0,0,0,0,0,0,0,0,0,0,0,0,0,0,0,0,0,0,0,0,0,0,0,0,0,0,0,0,0,0,0,0]
    ],
    [
      [0,0,0,0,0,0,0,0,0,0,0,0,0,0,0,0,0,0,0,0,0,0,0,0,0,0,0,0,0,0,0,0,0,0,0,0,0,0,0,0],
      [0,0,0,0,0,0,1400,0,0,0,0,0,0,0,0,0,0,0,0,0,0,0,0,0,0,0,0,0,0,0,0,0,0,0,0,0,0,0,0,0],
      [0,0,0,0,0,0,1438,0,0,0,0,0,0,0,0,0,0,0,0,0,0,0,0,0,0,0,0,0,0,0,0,0,0,0,0,0,0,0,0,0],
      [0,0,0,0,0,0,1438,0,0,0,0,0,0,0,0,0,0,0,0,0,0,0,0,0,0,0,0,0,0,0,0,0,0,0,0,0,0,0,0,0],
      [0,0,0,0,0,0,1438,0,0,0,0,0,0,0,0,0,0,0,0,0,0,0,0,0,0,0,0,0,0,0,0,0,0,0,0,0,0,0,0,0],
      [0,0,0,0,0,0,1438,0,0,0,0,0,0,0,0,0,0,0,0,0,0,0,0,0,0,0,0,0,0,0,0,0,0,0,0,0,0,0,0,0],
      [0,0,0,0,0,0,1438,0,0,0,0,0,0,0,0,0,0,0,0,0,0,0,0,0,0,0,0,0,0,0,0,0,0,0,0,0,0,0,0,0],
      [0,0,0,0,0,0,1438,0,0,0,0,0,0,0,0,0,0,0,0,0,0,0,0,0,0,0,0,0,0,0,0,0,0,0,0,0,0,0,0,0],
      [0,0,0,0,0,0,1438,0,0,0,0,0,0,0,0,0,0,0,0,0,0,0,0,0,0,0,0,0,0,0,0,0,0,0,0,0,0,0,0,0],
      [0,0,0,0,0,0,1438,0,0,0,0,0,0,0,0,0,0,0,0,0,0,0,0,0,0,0,0,0,0,0,0,0,0,0,0,0,0,0,0,0],
      [0,0,0,0,0,0,1438,0,0,0,0,0,0,0,0,0,0,0,0,0,0,0,0,0,0,0,0,0,0,0,0,0,0,0,0,0,0,0,0,0],
      [0,0,0,0,0,0,1438,0,0,0,0,0,0,0,0,0,0,0,0,0,0,0,0,0,0,0,0,0,0,0,0,0,0,0,0,0,0,0,0,0],
      [0,0,0,0,0,0,1438,0,0,0,0,0,0,0,0,0,0,0,0,0,0,0,0,0,0,0,0,0,0,0,0,0,0,0,0,0,0,0,0,0],
      [0,0,0,0,0,0,1438,0,0,0,0,0,0,0,0,0,0,0,0,0,0,0,0,0,0,0,0,0,0,0,0,0,0,0,0,0,0,0,0,0],
      [0,0,0,0,0,0,1438,0,0,0,0,0,0,0,0,0,0,0,0,0,0,0,0,0,0,0,0,0,0,0,0,0,0,0,0,0,0,0,0,0],
      [0,0,0,0,0,0,1438,0,0,0,0,0,0,0,0,0,0,0,0,0,0,0,0,0,0,0,0,0,0,0,0,0,0,0,0,0,0,0,0,0],
      [0,0,0,0,0,0,1438,0,0,0,0,0,0,0,0,0,0,0,0,0,0,0,0,0,0,0,0,0,0,0,0,0,0,0,0,0,0,0,0,0],
      [0,0,0,0,0,0,1438,0,0,0,0,0,0,0,0,0,0,0,0,0,0,0,0,0,0,0,0,0,0,0,0,0,0,0,0,0,0,0,0,0],
      [0,0,0,0,0,0,1442,1435,1435,1441,0,0,0,0,0,0,0,0,0,0,0,0,0,0,0,0,0,0,0,0,0,0,0,0,0,0,0,0,0,0],
      [0,0,0,0,0,0,0,0,0,1442,1441,0,0,0,0,0,0,0,0,0,0,0,0,0,0,0,0,0,0,0,0,0,0,0,0,0,0,0,0,0],
      [0,0,0,0,0,0,0,0,0,0,1798,0,0,0,0,0,0,0,0,0,0,0,0,0,0,0,0,0,0,0,0,0,0,0,0,0,0,0,0,0],
      [0,0,0,0,0,0,0,0,0,0,1798,0,0,0,0,0,0,0,0,0,0,0,0,0,0,0,0,0,0,0,0,0,0,0,0,0,0,0,0,0],
      [0,0,0,0,0,0,0,0,0,0,1744,0,0,0,0,0,0,0,0,0,0,0,0,0,0,0,0,0,0,0,0,0,0,0,0,0,0,0,0,0],
      [0,0,0,0,0,0,0,0,0,0,1798,0,0,0,0,0,0,0,0,0,0,0,0,0,0,0,0,0,0,0,0,0,0,0,0,0,0,0,0,0],
      [0,0,0,0,0,0,0,0,0,0,1438,0,0,0,0,0,0,0,0,0,0,0,0,0,0,0,0,0,0,0,0,0,0,0,0,0,0,0,0,0],
      [0,0,0,0,0,0,0,0,0,0,1438,0,0,0,0,0,0,0,0,0,0,0,0,0,0,0,0,0,0,0,0,0,0,0,0,0,0,0,0,0],
      [0,0,0,0,0,0,0,0,0,0,1438,0,0,0,0,0,0,0,0,0,0,0,0,0,0,0,0,0,0,0,0,0,0,0,0,0,0,0,0,0],
      [0,0,0,0,0,0,0,0,0,0,1438,0,0,0,0,0,0,0,0,0,0,0,0,0,0,0,0,0,0,0,0,0,0,0,0,0,0,0,0,0],
      [0,0,0,0,0,0,0,0,0,0,1438,0,0,0,0,0,0,0,0,0,0,0,0,0,0,0,0,0,0,0,0,0,0,0,0,0,0,0,0,0],
      [0,0,0,0,0,0,0,0,0,0,1438,0,0,0,0,0,0,0,0,0,0,0,0,0,0,0,0,0,0,0,0,0,0,0,0,0,0,0,0,0],
      [0,0,0,0,0,0,0,0,0,0,1438,0,0,0,0,0,0,0,0,0,0,0,0,0,0,0,0,0,0,0,0,0,0,0,0,0,0,0,0,0],
      [0,0,0,0,0,0,0,0,0,0,1438,0,0,0,0,0,0,0,0,0,0,0,0,0,0,0,0,0,0,0,0,0,0,0,0,0,0,0,0,0],
      [0,0,0,0,0,0,0,0,0,0,1744,0,0,0,0,0,0,0,0,0,0,0,0,0,0,0,0,0,0,0,0,0,0,0,0,0,0,0,0,0],
      [0,0,0,0,0,0,0,0,0,0,1744,0,0,0,0,0,0,0,0,0,0,0,0,0,0,0,0,0,0,0,0,0,0,0,0,0,0,0,0,0],
      [0,0,0,0,0,1400,0,0,0,0,1798,0,0,0,0,0,0,0,0,0,0,0,0,0,0,0,0,0,0,0,0,0,0,0,0,0,0,0,0,0],
      [0,0,0,0,0,1438,0,0,0,1386,1382,0,0,0,0,0,0,0,0,0,0,0,0,0,0,0,0,0,0,0,0,0,0,0,0,0,0,0,0,0],
      [0,0,0,0,0,1442,1435,1435,1435,1381,1382,0,0,0,0,0,0,0,0,0,0,0,0,0,0,0,0,0,0,0,0,0,0,0,0,0,0,0,0,0],
      [0,0,0,0,0,0,0,0,0,0,1438,0,0,0,0,0,0,0,0,0,0,0,0,0,0,0,0,0,0,0,0,0,0,0,0,0,0,0,0,0],
      [0,0,0,0,0,0,0,0,0,0,1442,1435,1435,1435,1435,1435,1435,1401,0,0,0,0,0,0,0,0,0,0,0,0,0,0,0,0,0,0,0,0,0,0],
      [0,0,0,0,0,0,0,0,0,0,0,0,0,0,0,0,0,0,0,0,0,0,0,0,0,0,0,0,0,0,0,0,0,0,0,0,0,0,0,0]
    ],
    [
      [0,0,0,0,0,0,0,0,0,0,0,0,0,0,0,0,0,0,0,0,0,0,0,0,0,0,0,0,0,0,0,0,0,0,0,0,0,0,0,0],
      [0,0,0,0,0,0,0,0,0,0,0,0,0,0,0,0,0,0,0,0,0,0,0,0,0,0,0,0,0,0,0,0,0,0,0,0,0,0,0,0],
      [0,0,0,0,0,0,0,0,0,0,0,0,0,0,0,0,0,0,0,0,0,0,0,0,0,0,0,0,0,0,0,0,0,0,0,0,0,0,0,0],
      [0,0,0,0,0,0,0,0,0,0,0,0,0,0,0,0,0,0,0,0,0,0,0,0,0,0,0,0,0,0,0,0,0,0,0,0,0,0,0,0],
      [0,0,0,0,0,0,0,0,0,0,0,0,0,0,0,0,0,0,0,0,0,0,0,0,0,0,0,0,0,0,0,0,0,0,0,0,0,0,0,0],
      [0,0,0,0,0,0,0,0,0,0,0,0,0,0,0,0,0,0,0,0,0,0,0,0,0,0,0,0,0,0,0,0,0,0,0,0,0,0,0,0],
      [0,0,0,0,0,0,0,0,0,0,0,0,0,0,0,0,0,0,0,0,0,0,0,0,0,0,0,0,0,0,0,0,0,0,0,0,0,0,0,0],
      [0,0,0,0,0,0,0,0,0,0,0,0,0,0,0,0,0,0,0,0,0,0,0,0,0,0,0,0,0,0,0,0,0,0,0,0,0,0,0,0],
      [0,0,0,0,0,0,0,0,0,0,0,0,0,0,0,0,0,0,0,0,0,0,0,0,0,0,0,0,0,0,0,0,0,0,0,0,0,0,0,0],
      [0,0,0,0,0,0,0,0,0,0,0,0,0,0,0,0,0,0,0,0,0,0,0,0,0,0,0,0,0,0,0,0,0,0,0,0,0,0,0,0],
      [0,0,0,0,0,0,0,0,0,0,0,0,0,0,0,0,0,0,0,0,0,0,0,0,0,0,0,0,0,0,0,0,0,0,0,0,0,0,0,0],
      [0,0,0,0,0,0,0,0,0,0,0,0,0,0,0,0,0,0,0,0,0,0,0,0,0,0,0,0,0,0,0,0,0,0,0,0,0,0,0,0],
      [0,0,0,0,0,0,0,0,0,0,0,0,0,0,0,0,0,0,0,0,0,0,0,0,0,0,0,0,0,0,0,0,0,0,0,0,0,0,0,0],
      [0,0,0,0,0,0,0,0,0,0,0,0,0,0,0,0,0,0,0,0,0,0,0,0,0,0,0,0,0,0,0,0,0,0,0,0,0,0,0,0],
      [0,0,0,0,0,0,0,0,0,0,0,0,0,0,0,0,0,0,0,0,0,0,0,0,0,0,0,0,0,0,0,0,0,0,0,0,0,0,0,0],
      [0,0,0,0,0,0,0,0,0,0,0,0,0,0,0,0,0,0,0,0,0,0,0,0,0,0,0,0,0,0,0,0,0,0,0,0,0,0,0,0],
      [0,0,0,0,0,0,0,0,0,0,0,0,0,0,0,0,0,0,0,0,0,0,0,0,0,0,0,0,0,0,0,0,0,0,0,0,0,0,0,0],
      [0,0,0,0,0,0,0,0,0,0,0,0,0,0,0,0,0,0,0,0,0,0,0,0,0,0,0,0,0,0,0,0,0,0,0,0,0,0,0,0],
      [0,0,0,0,0,0,0,0,0,0,0,0,0,0,0,0,0,0,0,0,0,0,0,0,0,0,0,0,0,0,0,0,0,0,0,0,0,0,0,0],
      [0,0,0,0,0,0,0,1634,1688,0,0,1634,1688,1634,1688,0,0,0,0,0,0,0,0,0,0,0,0,0,1688,1634,1688,0,0,0,0,0,0,0,0,0],
      [0,0,0,0,0,0,1634,1688,1634,1688,1634,1688,1634,1688,1634,1688,0,0,0,0,0,0,0,0,0,0,0,1688,1634,1688,1634,1688,1634,1688,1634,1688,0,0,0,0],
      [0,0,0,0,1688,1634,1688,1634,1688,1634,1688,1634,1688,1634,1688,1634,1688,0,0,0,0,0,0,0,1688,1634,1688,1634,1688,1634,1688,1634,1688,1634,1688,1634,1688,0,0,0],
      [0,0,0,1688,1634,1688,1634,1688,1634,1688,1634,1688,1634,1688,1634,1688,1634,1688,0,0,0,0,0,1688,1634,1688,1634,1688,1634,1688,1634,1688,1634,1688,1634,1688,1634,0,0,0],
      [0,0,0,1634,1688,1634,1688,1634,1688,1634,1688,1634,1688,1634,1688,1634,1688,1634,1688,0,0,0,1688,1634,1688,1634,1688,1634,1688,1634,1688,1634,1688,1634,1688,1634,1688,0,0,0],
      [0,0,0,1688,1634,1688,1634,1688,0,0,0,0,0,1688,1634,1688,1634,1688,1634,0,0,0,1634,1688,1634,1688,1634,1688,1634,1688,1634,1688,1634,1688,1634,1688,1634,0,0,0],
      [0,0,0,1634,1688,1634,1688,1634,0,0,0,0,0,0,1688,1634,1688,1634,1688,0,0,0,1688,1634,1688,1634,1688,1634,1688,1634,1688,1634,1688,1634,1688,1634,1688,0,0,0],
      [0,0,0,1688,1634,1688,1634,1688,0,0,0,0,0,0,1634,1688,1634,1688,1634,0,0,0,1634,1688,1634,1688,1634,1688,1634,1688,1634,1688,1634,1688,1634,1688,1634,0,0,0],
      [0,0,0,1634,1688,1634,1688,1634,0,0,0,0,0,0,0,1634,1688,1634,1688,0,0,0,1688,1634,1688,1634,1688,1634,1688,1634,1688,1634,1688,1634,1688,1634,1688,0,0,0],
      [0,0,0,1688,1634,1688,1634,0,0,0,0,0,0,0,1634,1688,1634,1688,1634,0,0,0,1634,1688,1634,1688,1634,1688,1634,1688,1634,1688,1634,1688,1634,1688,1634,0,0,0],
      [0,0,0,1634,1688,1634,0,0,0,0,0,0,0,1634,1688,1634,1688,1634,1688,0,0,0,1688,1634,1688,1634,1688,1634,1688,1634,1688,1634,1688,1634,1688,1634,1688,0,0,0],
      [0,0,0,1688,1634,1688,1634,0,0,0,0,0,1634,1688,1634,1688,1634,1688,0,0,0,0,1634,1688,1634,1688,1634,1688,1634,1688,1634,1688,1634,1688,1634,1688,1634,0,0,0],
      [0,0,0,1634,1688,1634,1688,1634,1688,1634,0,1634,1688,1634,1688,1634,1688,1634,0,0,0,0,1688,1634,1688,1634,1688,1634,1688,1634,1688,1634,1688,1634,1688,1634,1688,0,0,0],
      [0,0,0,0,1634,1688,1634,1688,1634,1688,1634,1688,1634,1688,1634,1688,1634,1688,0,0,0,0,0,1688,1634,1688,1634,1688,1634,1688,1634,1688,1634,1688,1634,1688,1634,0,0,0],
      [0,0,0,0,0,1634,1688,1634,1688,1634,1688,1634,1688,1634,1688,1634,1688,0,0,0,0,0,0,0,1688,1634,1688,1634,1688,1634,1688,1634,1688,1634,1688,1634,0,0,0,0],
      [0,0,0,0,0,0,1634,1688,1634,1688,1634,1688,1634,1688,1634,1688,0,0,0,0,0,0,0,0,0,0,1634,1688,1634,1688,1634,1688,1634,1688,1634,0,0,0,0,0],
      [0,0,0,0,0,0,1688,1634,1688,0,0,0,1688,1634,1688,0,0,0,0,0,0,0,0,0,0,0,0,0,1688,1634,1688,1634,1688,1634,0,0,0,0,0,0],
      [0,0,0,0,0,0,0,0,0,0,0,0,0,0,0,0,0,0,0,0,0,0,0,0,0,0,0,0,0,0,0,0,0,0,0,0,0,0,0,0],
      [0,0,0,0,0,0,0,0,0,0,0,0,0,0,0,0,0,0,0,0,0,0,0,0,0,0,0,0,0,0,0,0,0,0,0,0,0,0,0,0],
      [0,0,0,0,0,0,0,0,0,0,0,0,0,0,0,0,0,0,0,0,0,0,0,0,0,0,0,0,0,0,0,0,0,0,0,0,0,0,0,0],
      [0,0,0,0,0,0,0,0,0,0,0,0,0,0,0,0,0,0,0,0,0,0,0,0,0,0,0,0,0,0,0,0,0,0,0,0,0,0,0,0]
    ],
    [
      [0,0,0,0,0,0,0,0,0,0,0,0,0,0,0,0,0,0,0,0,0,0,0,0,0,0,0,0,0,0,0,0,0,0,0,0,0,0,0,0],
      [0,0,0,0,0,0,0,0,0,0,0,0,0,0,0,0,0,0,0,0,0,0,0,0,0,0,0,0,0,0,0,0,0,0,0,0,0,0,0,0],
      [0,0,0,0,0,0,0,0,0,0,0,0,0,0,0,0,0,0,0,0,0,0,0,0,0,0,0,0,0,0,0,0,0,0,0,0,0,0,0,0],
      [0,0,0,0,0,0,0,0,0,0,0,0,0,0,0,0,0,0,0,0,0,0,0,0,0,0,0,0,0,0,0,0,0,0,0,0,0,0,0,0],
      [0,0,0,0,0,0,0,0,0,0,0,0,0,0,0,0,0,0,0,0,0,0,0,0,0,0,0,0,0,0,0,0,0,0,0,0,0,0,0,0],
      [0,0,0,0,0,0,0,0,0,0,0,0,0,0,0,0,0,0,0,0,0,0,0,0,0,0,0,0,0,0,0,0,0,0,0,0,0,0,0,0],
      [0,0,0,0,0,0,0,0,0,0,0,0,0,0,0,0,0,0,0,0,0,0,0,0,0,0,0,0,0,0,0,0,0,0,0,0,0,0,0,0],
      [0,0,0,0,0,0,0,0,0,0,0,0,0,0,0,0,0,0,0,0,0,0,0,0,0,0,0,0,0,0,0,0,0,0,0,0,0,0,0,0],
      [0,0,0,0,0,0,0,0,0,0,0,0,0,0,0,0,0,0,0,0,0,0,0,0,0,0,0,0,0,0,0,0,0,0,0,0,0,0,0,0],
      [0,0,0,0,0,0,0,0,0,0,0,0,0,0,0,0,0,0,0,0,0,0,0,0,0,0,0,0,0,0,0,0,0,0,0,0,0,0,0,0],
      [0,0,0,0,0,0,0,0,0,0,0,0,0,0,0,0,0,0,0,0,0,0,0,0,0,0,0,0,0,0,0,0,0,0,0,0,0,0,0,0],
      [0,0,0,0,0,0,0,0,0,0,0,0,0,0,0,0,0,0,0,0,0,0,0,0,0,0,0,0,0,0,0,0,0,0,0,0,0,0,0,0],
      [0,0,0,0,0,0,0,0,0,0,0,0,0,0,0,0,0,0,0,0,0,0,0,0,0,0,0,0,0,0,0,0,0,0,0,0,0,0,0,0],
      [0,0,0,0,0,0,0,0,0,0,0,0,0,0,0,0,0,0,0,0,0,0,0,0,0,0,0,0,0,0,0,0,0,0,0,0,0,0,0,0],
      [0,0,0,0,0,0,0,0,0,0,0,0,0,0,0,0,0,0,0,0,0,0,0,0,0,0,0,0,0,0,0,0,0,0,0,0,0,0,0,0],
      [0,0,0,0,0,0,0,0,0,0,0,0,0,0,0,0,0,0,0,0,0,0,0,0,0,0,0,0,0,0,0,0,0,0,0,0,0,0,0,0],
      [0,0,0,0,0,0,0,0,0,0,0,0,0,0,0,0,0,0,0,0,0,0,0,0,0,0,0,0,0,0,0,0,0,0,0,0,0,0,0,0],
      [0,0,0,0,0,0,0,0,0,0,0,0,0,0,0,0,0,0,0,0,0,0,0,0,0,0,0,0,0,0,0,0,0,0,0,0,0,0,0,0],
      [0,0,0,0,0,0,0,0,0,0,0,0,0,0,0,0,0,0,0,0,0,0,0,0,0,0,0,0,0,0,0,0,0,0,0,0,0,0,0,0],
      [0,0,0,0,0,0,0,1472,1474,0,0,1472,1473,1473,1474,0,0,0,0,0,0,0,0,0,0,0,0,0,1472,1473,1474,0,0,0,0,0,0,0,0,0],
      [0,0,0,0,0,0,1472,0,0,1473,1473,0,0,0,0,1474,0,0,0,0,0,0,0,0,0,0,0,1472,0,0,0,1473,1473,1473,1473,1474,0,0,0,0],
      [0,0,0,0,1472,1473,0,0,0,0,0,0,0,0,0,0,1474,0,0,0,0,0,0,0,1472,1473,1473,0,0,0,0,0,0,0,0,0,1474,0,0,0],
      [0,0,0,1472,0,0,0,0,0,0,0,0,0,0,0,0,0,1474,0,0,0,0,0,1472,0,0,0,0,0,0,0,0,0,0,0,0,1528,0,0,0],
      [0,0,0,1526,0,0,0,0,1581,1581,0,1581,1581,0,0,0,0,0,1474,0,0,0,1472,0,0,0,0,0,0,0,0,0,0,0,0,0,1528,0,0,0],
      [0,0,0,1526,0,0,0,1528,0,0,0,0,0,1580,0,0,0,0,1528,0,0,0,1526,0,0,0,0,0,0,0,0,0,0,0,0,0,1528,0,0,0],
      [0,0,0,1526,0,0,0,1528,0,0,0,0,0,0,1526,0,0,0,1528,0,0,0,1526,0,0,0,0,0,0,0,0,0,0,0,0,0,1528,0,0,0],
      [0,0,0,1526,0,0,0,1528,0,0,0,0,0,0,1580,0,0,0,1528,0,0,0,1526,0,0,0,0,0,0,0,0,0,0,0,0,0,1528,0,0,0],
      [0,0,0,1526,0,0,0,1582,0,0,0,0,0,0,0,1526,0,0,1528,0,0,0,1526,0,0,0,0,0,0,0,0,0,0,0,0,0,1528,0,0,0],
      [0,0,0,1526,0,0,1582,0,0,0,0,0,0,0,1472,0,0,0,1528,0,0,0,1526,0,0,0,0,0,0,0,0,0,0,0,0,0,1528,0,0,0],
      [0,0,0,1526,0,1528,0,0,0,0,0,0,0,1472,0,0,0,0,1582,0,0,0,1526,0,0,0,0,0,0,0,0,0,0,0,0,0,1528,0,0,0],
      [0,0,0,1526,0,0,1474,0,0,0,0,0,1472,0,0,0,0,1528,0,0,0,0,1526,0,0,0,0,0,0,0,0,0,0,0,0,0,1528,0,0,0],
      [0,0,0,1580,0,0,0,1473,1473,1474,0,1472,0,0,0,0,0,1528,0,0,0,0,1580,0,0,0,0,0,0,0,0,0,0,0,0,0,1528,0,0,0],
      [0,0,0,0,1580,0,0,0,0,0,1473,0,0,0,0,0,0,1582,0,0,0,0,0,1580,0,0,0,0,0,0,0,0,0,0,0,0,1582,0,0,0],
      [0,0,0,0,0,1580,0,0,0,0,0,0,0,0,0,0,1582,0,0,0,0,0,0,0,1580,1581,0,0,0,0,0,0,0,0,0,1582,0,0,0,0],
      [0,0,0,0,0,0,1526,0,0,1581,1581,1581,0,0,0,1582,0,0,0,0,0,0,0,0,0,0,1580,1581,0,0,0,0,0,0,1582,0,0,0,0,0],
      [0,0,0,0,0,0,1580,1581,1582,0,0,0,1580,1581,1582,0,0,0,0,0,0,0,0,0,0,0,0,0,1580,1581,1581,1581,1581,1582,0,0,0,0,0,0],
      [0,0,0,0,0,0,0,0,0,0,0,0,0,0,0,0,0,0,0,0,0,0,0,0,0,0,0,0,0,0,0,0,0,0,0,0,0,0,0,0],
      [0,0,0,0,0,0,0,0,0,0,0,0,0,0,0,0,0,0,0,0,0,0,0,0,0,0,0,0,0,0,0,0,0,0,0,0,0,0,0,0],
      [0,0,0,0,0,0,0,0,0,0,0,0,0,0,0,0,0,0,0,0,0,0,0,0,0,0,0,0,0,0,0,0,0,0,0,0,0,0,0,0],
      [0,0,0,0,0,0,0,0,0,0,0,0,0,0,0,0,0,0,0,0,0,0,0,0,0,0,0,0,0,0,0,0,0,0,0,0,0,0,0,0]
    ],
    [
      [0,0,0,0,0,0,0,0,0,0,0,0,0,0,0,0,0,0,0,0,0,0,0,0,0,0,0,0,0,0,0,0,0,0,0,0,0,0,0,0],
      [0,0,0,0,0,49,0,0,0,0,0,0,0,51,50,0,0,0,0,0,0,215,51,0,0,0,0,267,268,51,0,0,50,0,0,0,49,208,0,0],
      [0,0,0,0,321,0,0,52,0,0,216,0,0,267,266,266,268,0,0,0,0,321,0,267,268,0,0,376,375,321,0,267,266,266,268,0,0,0,0,0],
      [0,0,50,267,322,0,0,0,0,0,50,0,267,321,321,321,321,266,321,0,321,322,0,320,321,321,52,0,0,0,0,320,321,321,322,216,0,0,0,0],
      [0,0,0,320,322,0,0,0,0,51,0,0,320,321,321,321,375,374,0,0,0,321,0,376,374,0,0,0,50,0,208,320,321,321,322,0,0,0,0,0],
      [0,0,0,320,322,0,0,0,0,0,0,0,376,375,375,374,0,0,0,0,0,0,0,0,0,0,0,0,0,0,0,376,321,321,374,0,0,0,0,0],
      [0,208,0,376,374,0,0,0,50,0,0,0,0,0,0,0,0,0,0,0,0,0,0,0,0,49,0,0,49,0,0,0,376,374,0,0,0,0,0,0],
      [0,0,0,0,0,0,0,0,0,0,0,0,267,266,266,268,0,0,0,0,0,0,0,0,0,215,0,0,0,215,0,0,52,0,49,0,0,0,0,0],
      [0,208,0,0,50,208,0,50,0,0,0,0,376,375,375,374,0,0,215,0,0,0,208,0,0,50,0,0,0,0,0,0,51,0,0,0,0,0,0,0],
      [0,0,0,0,0,52,0,0,0,0,0,50,0,0,0,0,0,0,0,215,208,49,0,0,208,0,0,0,0,0,0,0,0,0,0,0,0,0,0,0],
      [0,0,0,0,0,215,0,0,0,0,0,208,0,321,321,321,208,0,0,0,0,215,0,0,0,49,0,216,0,0,0,0,0,0,0,0,0,51,0,0],
      [0,0,267,268,0,52,0,0,0,0,0,0,0,0,49,0,0,0,0,0,0,0,52,0,0,0,0,0,0,0,0,0,0,216,0,0,0,215,0,0],
      [0,0,376,374,0,0,0,0,50,0,0,0,0,267,266,268,0,0,0,50,0,0,52,0,0,0,0,0,0,0,0,0,52,215,0,0,0,0,321,0],
      [0,216,0,0,0,0,0,0,0,0,0,0,0,376,375,374,49,0,50,0,0,0,0,0,0,0,0,0,0,0,0,0,0,0,0,0,0,267,322,0],
      [0,51,321,0,0,0,0,0,0,0,0,0,0,0,0,0,0,0,216,0,0,52,0,0,0,0,49,0,49,0,267,268,49,0,0,267,266,321,322,0],
      [0,321,0,0,0,0,0,0,0,0,0,216,0,0,0,0,0,0,0,0,0,0,0,0,0,0,50,0,0,216,320,321,268,0,0,376,375,375,374,0],
      [0,51,0,0,0,0,0,0,0,0,0,0,215,0,0,0,0,0,0,0,0,0,0,0,0,267,268,0,0,321,321,321,374,0,0,0,0,0,0,0],
      [0,0,0,0,0,0,0,0,0,0,0,0,0,0,0,216,0,0,0,0,0,0,0,267,266,321,322,208,0,0,376,374,0,0,0,0,0,0,0,0],
      [0,0,0,49,0,0,0,0,0,0,0,0,0,0,0,0,0,0,0,0,0,0,0,376,375,375,374,0,0,0,0,0,0,0,49,50,0,0,0,0],
      [0,216,0,0,0,0,0,0,0,0,0,0,0,0,0,0,0,0,0,0,0,0,0,0,0,0,0,0,0,0,0,0,0,0,0,0,0,0,0,0],
      [0,0,0,0,0,0,0,0,0,0,0,0,0,0,0,0,0,0,0,51,0,0,0,0,0,0,0,0,0,0,0,0,0,0,0,0,0,0,0,0],
      [0,0,0,0,0,0,0,0,0,0,0,0,0,0,0,0,0,0,0,0,0,0,0,0,0,0,0,0,0,0,0,0,0,0,0,0,0,0,0,0],
      [0,0,0,0,0,0,0,0,0,0,0,0,0,0,0,0,0,0,0,0,0,0,0,0,0,0,0,0,0,0,0,0,0,0,0,0,0,0,0,0],
      [0,0,0,0,0,0,0,0,0,0,0,0,0,0,0,0,0,0,0,0,0,0,0,0,0,0,0,0,0,0,0,0,0,0,0,0,0,0,0,0],
      [0,0,0,0,0,0,0,0,0,0,0,0,0,0,0,0,0,0,0,0,0,0,0,0,0,0,0,0,0,0,0,0,0,0,0,0,0,0,0,0],
      [0,0,0,0,0,0,0,0,216,0,0,0,321,0,0,0,0,0,0,0,0,0,0,0,0,0,0,0,0,0,0,0,0,0,0,0,0,0,0,0],
      [0,0,0,0,0,0,0,0,209,0,0,0,321,0,0,0,0,0,0,0,0,0,0,0,0,0,0,0,0,0,0,0,0,0,0,0,0,0,0,0],
      [0,0,0,0,0,0,0,0,0,0,0,0,321,0,0,0,0,0,0,0,0,0,0,0,0,0,0,0,0,0,0,0,0,0,0,0,0,0,0,0],
      [0,0,0,0,0,0,0,208,0,208,0,0,0,0,0,0,0,0,0,0,0,0,0,0,0,0,0,0,0,0,0,0,0,0,0,0,0,0,0,0],
      [0,0,0,0,0,0,0,0,0,0,0,0,0,0,0,0,0,0,0,0,0,0,0,0,0,0,0,0,0,0,0,0,0,0,0,0,0,0,0,0],
      [0,0,0,0,0,0,0,0,0,0,0,0,0,0,0,0,0,0,0,0,0,0,0,0,0,0,0,0,0,0,0,0,0,0,0,0,0,0,0,0],
      [0,0,0,0,0,0,0,0,0,0,0,0,0,0,0,0,0,0,0,0,0,0,0,0,0,0,0,0,0,0,0,0,0,0,0,0,0,0,0,0],
      [0,0,0,0,0,0,0,0,0,0,0,0,0,0,0,0,0,0,0,0,0,0,0,0,0,0,0,0,0,0,0,0,0,0,0,0,0,0,0,0],
      [0,0,0,0,0,0,0,0,0,0,0,0,0,0,0,0,0,0,0,0,215,0,0,0,0,0,0,0,0,0,0,0,0,0,0,0,0,0,0,0],
      [0,216,267,268,0,570,0,0,0,0,0,0,0,0,0,0,0,0,0,0,0,0,0,0,0,0,0,0,0,0,0,0,0,0,0,0,0,0,0,0],
      [0,267,321,322,0,0,0,0,0,0,0,0,0,0,0,0,0,0,0,0,0,0,0,0,49,0,0,0,0,0,0,0,0,0,0,0,0,0,0,0],
      [0,320,321,322,0,0,0,0,0,0,0,0,0,0,0,0,0,0,50,0,0,0,0,0,0,267,268,0,0,0,0,0,0,0,0,209,0,0,0,0],
      [0,376,321,322,49,0,51,215,0,0,0,0,0,0,0,0,0,0,208,215,0,0,216,0,321,321,321,321,0,321,0,50,0,0,0,0,0,0,0,0],
      [0,215,376,374,0,0,0,321,321,0,0,0,0,0,0,0,0,0,0,0,0,0,52,0,0,376,374,0,0,321,208,0,50,51,0,0,0,0,215,0],
      [0,0,0,0,0,0,0,0,0,0,0,0,0,0,0,0,0,0,0,0,0,0,0,0,0,0,0,0,0,0,0,0,0,0,0,0,0,0,0,0]
    ]
  ]
}