{
  "name": "Teachin_an_Drucht",
  "width": 20,
  "height": 20,
  "layers": [
    [
      [733,733,733,733,733,733,733,733,733,733,733,733,733,733,733,733,733,733,733,733],
      [733,733,733,733,733,733,733,733,733,733,733,733,733,733,733,733,733,733,733,733],
      [733,733,1379,1379,1379,1379,1379,733,733,733,733,733,733,733,733,733,733,733,733,733],
      [733,1379,1379,1379,1379,1379,1379,1379,733,733,733,733,733,733,733,733,733,733,733,733],
      [733,1379,1379,1379,1379,1379,1379,1379,733,733,733,733,733,733,733,733,733,733,733,733],
      [733,1379,1379,1379,1379,1379,1379,1379,733,733,733,733,733,733,733,733,733,733,733,733],
      [733,733,1379,1379,1379,1379,1379,733,733,733,733,733,733,733,733,733,733,733,733,733],
      [733,733,733,733,1379,733,733,733,733,733,733,733,733,733,733,733,733,733,733,733],
      [733,733,733,733,1379,733,733,733,733,733,733,733,733,733,733,733,733,733,733,733],
      [733,733,733,733,112,112,112,112,112,112,733,733,733,733,733,733,733,733,733,733],
      [733,733,733,733,112,112,112,112,112,112,733,733,733,733,733,733,733,733,733,733],
      [733,733,733,733,112,112,112,112,112,112,733,733,733,733,733,733,733,733,733,733],
      [733,733,733,733,112,112,112,112,112,112,733,733,733,733,733,733,733,733,733,733],
      [733,733,733,733,733,733,733,733,733,733,733,733,733,733,733,733,733,733,733,733],
      [733,733,733,733,733,733,733,733,733,733,733,733,733,733,733,733,733,733,733,733],
      [733,733,733,733,733,733,733,733,733,733,733,733,733,733,733,733,733,733,733,733],
      [733,733,733,733,733,733,733,733,733,733,733,733,733,733,733,733,733,733,733,733],
      [733,733,733,733,733,733,733,733,733,733,733,733,733,733,733,733,733,733,733,733],
      [733,733,733,733,733,733,733,733,733,733,733,733,733,733,733,733,733,733,733,733],
      [733,733,733,733,733,733,733,733,733,733,733,733,733,733,733,733,733,733,733,733]
    ],
    [
      [0,0,0,0,0,0,0,0,0,0,0,0,0,0,0,0,0,0,0,0],
      [0,0,0,0,0,0,0,0,0,0,0,0,0,0,0,0,0,0,0,0],
      [0,0,0,0,0,0,0,0,0,0,0,0,0,0,0,0,0,0,0,0],
      [0,0,0,0,0,0,0,0,0,0,0,0,0,0,0,0,0,0,0,0],
      [0,0,0,0,0,0,0,0,0,0,0,0,0,0,0,0,0,0,0,0],
      [0,0,0,0,0,0,0,0,0,0,0,0,0,0,0,0,0,0,0,0],
      [0,0,0,0,0,0,0,0,0,0,0,0,0,0,0,0,0,0,0,0],
      [0,0,0,0,0,0,0,0,0,0,0,0,0,0,0,0,0,0,0,0],
      [0,0,0,125,120,120,120,120,120,126,0,0,0,0,0,0,0,0,0,0],
      [0,0,0,123,0,0,0,0,0,123,0,0,0,0,0,0,0,0,0,0],
      [0,0,0,123,0,0,0,0,0,123,0,0,0,0,0,0,0,0,0,0],
      [0,0,0,123,0,0,0,0,0,123,0,0,0,0,0,0,0,0,0,0],
      [0,0,0,127,120,137,120,120,120,128,0,0,0,0,0,0,0,0,0,0],
      [0,0,0,0,0,0,0,0,0,0,0,0,0,0,0,0,0,0,0,0],
      [0,0,0,0,0,0,0,0,0,0,0,0,0,0,0,0,0,0,0,0],
      [0,0,0,0,0,0,0,0,0,0,0,0,0,0,0,0,0,0,0,0],
      [0,0,0,0,0,0,0,0,0,0,0,0,0,0,0,0,0,0,0,0],
      [0,0,0,0,0,0,0,0,0,0,0,0,0,0,0,0,0,0,0,0],
      [0,0,0,0,0,0,0,0,0,0,0,0,0,0,0,0,0,0,0,0],
      [0,0,0,0,0,0,0,0,0,0,0,0,0,0,0,0,0,0,0,0]
    ],
    [
      [211,0,211,0,211,0,0,0,0,0,0,0,211,0,211,0,0,0,0,0],
      [0,0,0,0,0,0,0,0,0,0,0,0,0,0,0,0,0,0,211,0],
      [0,0,0,466,0,0,0,0,0,0,0,0,0,0,0,0,0,0,0,0],
      [0,0,0,0,0,0,0,0,0,0,0,0,0,0,0,0,0,0,0,0],
      [0,0,0,0,44,0,0,45,0,0,0,0,0,0,0,0,0,0,0,0],
      [0,0,0,0,0,0,0,0,0,0,0,0,0,0,0,0,0,0,0,0],
      [0,0,0,0,0,0,0,0,0,0,0,0,0,0,0,0,0,0,0,0],
      [0,0,0,0,0,0,0,0,0,0,0,0,0,0,0,0,0,0,0,0],
      [0,0,0,0,0,0,0,0,0,0,0,0,0,0,0,0,0,0,0,0],
      [0,0,0,0,41,0,0,255,0,0,0,0,0,0,0,0,0,0,0,0],
      [0,0,0,0,0,0,0,0,0,0,0,0,0,0,0,0,0,0,0,0],
      [0,0,0,0,250,251,0,0,0,0,0,0,0,0,0,0,0,0,0,0],
      [0,0,0,0,0,0,0,0,0,0,0,0,0,0,0,0,0,0,0,0],
      [0,0,0,0,0,0,467,0,0,0,0,0,0,0,0,0,0,0,0,0],
      [0,0,411,0,0,0,0,0,0,409,0,0,0,0,0,0,0,0,0,0],
      [0,0,0,0,0,0,0,0,0,0,0,0,0,0,0,0,0,0,0,0],
      [0,0,0,0,211,0,211,0,211,0,211,0,0,0,0,0,0,0,0,0],
      [0,0,0,0,0,0,0,0,0,0,0,0,0,0,0,0,0,0,0,0],
      [0,0,0,0,0,0,0,0,0,0,0,0,0,0,0,0,0,0,0,0],
      [0,0,0,0,0,0,0,0,0,0,0,0,0,0,0,0,0,0,0,0]
    ]
  ]
}
 
